count,registered,casual,hour1,temp,humidity,year1,season,windspeed
16,13,3,0,9.84,81,2011,1,9.3258754
40,32,8,1,9.02,80,2011,1,9.103401335
32,27,5,2,9.02,80,2011,1,9.103401335
13,10,3,3,9.84,75,2011,1,9.219943835
1,1,0,4,9.84,75,2011,1,9.219943835
1,1,0,5,9.84,75,2011,1,6.0032
2,0,2,6,9.02,80,2011,1,9.103401335
3,2,1,7,8.2,86,2011,1,8.840891689
8,7,1,8,9.84,75,2011,1,9.219943835
14,6,8,9,13.12,76,2011,1,11.95480415
36,24,12,10,15.58,76,2011,1,16.9979
56,30,26,11,14.76,81,2011,1,19.0012
84,55,29,12,17.22,77,2011,1,19.0012
94,47,47,13,18.86,72,2011,1,19.9995
106,71,35,14,18.86,72,2011,1,19.0012
110,70,40,15,18.04,77,2011,1,19.9995
93,52,41,16,17.22,82,2011,1,19.9995
67,52,15,17,18.04,82,2011,1,19.0012
35,26,9,18,17.22,88,2011,1,16.9979
37,31,6,19,17.22,88,2011,1,16.9979
36,25,11,20,16.4,87,2011,1,16.9979
34,31,3,21,16.4,87,2011,1,12.998
28,17,11,22,16.4,94,2011,1,15.0013
39,24,15,23,18.86,88,2011,1,19.9995
17,13,4,0,18.86,88,2011,1,19.9995
17,16,1,1,18.04,94,2011,1,16.9979
9,8,1,2,17.22,100,2011,1,19.0012
6,4,2,3,18.86,94,2011,1,12.998
3,1,2,4,18.86,94,2011,1,12.998
2,2,0,6,17.22,77,2011,1,19.9995
1,1,0,7,16.4,76,2011,1,12.998
8,8,0,8,16.4,71,2011,1,15.0013
20,19,1,9,15.58,76,2011,1,15.0013
53,46,7,10,14.76,81,2011,1,15.0013
70,54,16,11,14.76,71,2011,1,16.9979
93,73,20,12,14.76,66,2011,1,19.9995
75,64,11,13,14.76,66,2011,1,8.9981
59,55,4,14,14.76,76,2011,1,12.998
74,55,19,15,13.94,81,2011,1,11.0014
76,67,9,16,13.94,71,2011,1,11.0014
65,58,7,17,13.94,57,2011,1,12.998
53,43,10,18,14.76,46,2011,1,22.0028
30,29,1,19,13.12,42,2011,1,30.0026
22,17,5,20,12.3,39,2011,1,23.9994
31,20,11,21,10.66,44,2011,1,22.0028
9,9,0,22,9.84,44,2011,1,19.9995
8,8,0,23,9.02,47,2011,1,11.0014
5,5,0,0,9.02,44,2011,1,23.9994
2,2,0,1,8.2,44,2011,1,27.9993
1,1,0,4,6.56,47,2011,1,26.0027
3,3,0,5,6.56,47,2011,1,19.0012
30,30,0,6,5.74,50,2011,1,26.0027
64,63,1,7,5.74,50,2011,1,12.998
154,153,1,8,5.74,50,2011,1,19.0012
88,81,7,9,6.56,43,2011,1,26.0027
44,33,11,10,7.38,43,2011,1,16.9979
51,41,10,11,8.2,40,2011,1,22.0028
61,48,13,12,9.02,35,2011,1,19.9995
61,53,8,13,9.84,35,2011,1,19.0012
77,66,11,14,10.66,30,2011,1,19.0012
72,58,14,15,10.66,30,2011,1,16.9979
76,67,9,16,10.66,30,2011,1,16.9979
157,146,11,17,9.84,30,2011,1,15.0013
157,148,9,18,9.84,32,2011,1,7.0015
110,102,8,19,8.2,47,2011,1,7.35927759
52,49,3,20,8.2,47,2011,1,7.0015
52,49,3,21,7.38,64,2011,1,8.9981
20,20,0,22,5.74,69,2011,1,8.9981
12,11,1,23,7.38,55,2011,1,7.0015
5,5,0,0,6.56,55,2011,1,7.0015
2,2,0,1,6.56,59,2011,1,7.0015
1,1,0,2,5.74,63,2011,1,8.9981
2,2,0,4,5.74,63,2011,1,6.0032
4,4,0,5,4.92,68,2011,1,7.0015
36,36,0,6,4.92,74,2011,1,7.0015
94,92,2,7,4.92,74,2011,1,8.9981
179,177,2,8,5.74,69,2011,1,11.0014
100,98,2,9,6.56,64,2011,1,15.0013
42,37,5,10,6.56,69,2011,1,22.0028
57,50,7,11,9.02,51,2011,1,19.9995
78,66,12,12,9.02,51,2011,1,11.0014
97,79,18,13,9.84,56,2011,1,12.998
63,54,9,14,10.66,52,2011,1,15.0013
65,48,17,15,11.48,52,2011,1,16.9979
83,68,15,16,12.3,49,2011,1,16.9979
212,202,10,17,11.48,48,2011,1,15.0013
182,179,3,18,10.66,48,2011,1,12.998
112,110,2,19,9.84,48,2011,1,7.0015
54,53,1,20,9.84,48,2011,1,7.0015
48,48,0,21,9.02,64,2011,1,8.451895256
35,34,1,22,9.02,64,2011,1,6.0032
11,9,2,23,8.2,69,2011,1,6.0032
6,6,0,0,8.2,64,2011,1,7.862588555
6,6,0,1,6.56,74,2011,1,6.0032
2,2,0,2,6.56,74,2011,1,6.0032
2,2,0,4,9.84,48,2011,1,15.0013
3,3,0,5,9.02,47,2011,1,11.0014
33,33,0,6,8.2,47,2011,1,15.0013
88,87,1,7,7.38,43,2011,1,12.998
195,192,3,8,8.2,40,2011,1,19.9995
115,109,6,9,9.02,37,2011,1,22.0028
57,53,4,10,9.02,37,2011,1,22.0028
46,34,12,11,10.66,33,2011,1,22.0028
79,74,5,12,10.66,33,2011,1,22.0028
71,65,6,13,11.48,30,2011,1,19.9995
62,52,10,14,12.3,28,2011,1,12.998
62,55,7,15,12.3,28,2011,1,12.998
89,85,4,16,12.3,28,2011,1,6.0032
190,186,4,17,9.84,38,2011,1,12.998
169,166,3,18,9.84,38,2011,1,8.9981
132,127,5,19,9.84,38,2011,1,7.0015
89,82,7,20,9.02,47,2011,1,11.0014
43,40,3,21,8.2,51,2011,1,12.998
42,41,1,22,7.38,55,2011,1,8.9981
19,18,1,23,8.2,47,2011,1,7.35927759
11,11,0,0,7.38,55,2011,1,7.303871106
4,4,0,1,6.56,64,2011,1,7.807797576
2,2,0,2,6.56,64,2011,1,7.807797576
1,1,0,4,6.56,64,2011,1,6.0032
4,4,0,5,5.74,69,2011,1,6.0032
36,36,0,6,5.74,63,2011,1,7.0015
95,95,0,7,6.56,59,2011,1,6.956104503
219,216,3,8,6.56,59,2011,1,6.969592506
122,116,6,9,7.38,51,2011,1,7.530845693
45,42,3,10,8.2,47,2011,1,7.35927759
59,57,2,11,9.02,44,2011,1,6.0032
84,78,6,12,10.66,35,2011,1,12.50818239
67,55,12,13,10.66,35,2011,1,7.0015
70,59,11,14,11.48,36,2011,1,11.0014
62,54,8,15,11.48,36,2011,1,17.43147849
86,74,12,16,10.66,38,2011,1,11.0014
172,163,9,17,9.02,51,2011,1,11.0014
163,158,5,18,9.02,51,2011,1,8.9981
112,109,3,19,9.02,55,2011,1,6.0032
69,66,3,20,8.2,51,2011,1,11.0014
48,48,0,21,9.02,55,2011,1,15.0013
52,51,1,22,9.02,51,2011,1,19.0012
23,19,4,23,8.2,59,2011,1,12.998
17,13,4,0,8.2,64,2011,1,12.998
7,5,2,1,8.2,69,2011,1,15.0013
1,1,0,2,8.2,69,2011,1,15.0013
1,1,0,4,8.2,69,2011,1,8.9981
5,5,0,5,9.02,55,2011,1,14.87533187
34,26,8,6,8.2,69,2011,1,8.778911983
84,76,8,7,8.2,69,2011,1,8.9981
210,190,20,8,8.2,51,2011,1,16.9979
134,125,9,9,8.2,47,2011,1,19.9995
63,47,16,10,9.02,37,2011,1,22.0028
67,48,19,11,8.2,40,2011,1,15.0013
59,50,9,12,8.2,37,2011,1,16.9979
73,64,9,13,8.2,37,2011,1,19.0012
50,43,7,14,8.2,40,2011,1,16.9979
72,63,9,15,8.2,37,2011,1,11.0014
87,82,5,16,8.2,37,2011,1,11.0014
187,178,9,17,8.2,37,2011,1,7.201482266
123,116,7,18,8.2,40,2011,1,6.0032
95,92,3,19,6.56,55,2011,1,6.0032
51,50,1,20,7.38,47,2011,1,7.0015
39,39,0,21,7.38,47,2011,1,8.9981
36,34,2,22,7.38,43,2011,1,11.0014
15,14,1,23,7.38,51,2011,1,11.0014
25,24,1,0,7.38,51,2011,1,11.0014
16,15,1,1,7.38,55,2011,1,6.0032
16,13,3,2,7.38,55,2011,1,7.28945845
7,7,0,3,7.38,55,2011,1,11.0014
1,1,0,4,7.38,55,2011,1,11.0014
5,5,0,5,6.56,74,2011,1,11.0014
2,2,0,6,6.56,74,2011,1,11.0014
9,8,1,7,6.56,74,2011,1,7.0015
15,15,0,8,6.56,93,2011,1,7.0015
20,20,0,9,6.56,93,2011,1,7.0015
61,56,5,10,7.38,80,2011,1,11.0014
62,60,2,11,8.2,69,2011,1,26.0027
98,90,8,12,8.2,59,2011,1,23.9994
102,95,7,13,8.2,44,2011,1,22.0028
95,83,12,14,8.2,32,2011,1,32.9975
74,69,5,15,8.2,32,2011,1,30.0026
76,68,8,16,7.38,29,2011,1,30.0026
69,64,5,17,6.56,37,2011,1,36.9974
55,52,3,18,5.74,39,2011,1,19.9995
30,26,4,19,5.74,36,2011,1,16.9979
28,28,0,20,4.92,36,2011,1,16.9979
37,35,2,21,4.92,39,2011,1,23.9994
34,33,1,22,4.92,36,2011,1,26.0027
22,22,0,23,4.1,39,2011,1,30.0026
25,24,1,0,4.1,42,2011,1,26.0027
12,12,0,1,4.1,42,2011,1,31.0009
11,11,0,2,4.1,46,2011,1,31.0009
4,4,0,3,4.1,46,2011,1,27.9993
1,1,0,4,3.28,53,2011,1,12.998
1,1,0,5,3.28,53,2011,1,12.998
1,1,0,6,4.1,49,2011,1,19.0012
6,5,1,7,3.28,53,2011,1,12.998
10,10,0,8,4.1,49,2011,1,19.0012
19,19,0,9,4.92,46,2011,1,35.0008
49,49,0,10,5.74,43,2011,1,26.0027
49,47,2,11,6.56,40,2011,1,35.0008
83,79,4,12,7.38,37,2011,1,30.0026
75,69,6,13,8.2,34,2011,1,30.0026
72,64,8,14,9.02,32,2011,1,31.0009
82,77,5,15,9.02,35,2011,1,23.9994
92,79,13,16,8.2,34,2011,1,30.0026
62,59,3,17,7.38,37,2011,1,26.0027
48,44,4,18,6.56,40,2011,1,22.0028
41,40,1,19,6.56,43,2011,1,22.0028
38,38,0,20,5.74,46,2011,1,16.9979
20,19,1,21,5.74,46,2011,1,27.9993
15,10,5,22,5.74,46,2011,1,19.9995
6,6,0,23,4.92,50,2011,1,12.998
5,3,2,0,4.92,50,2011,1,19.0012
1,0,1,1,4.92,50,2011,1,19.0012
3,3,0,2,4.92,50,2011,1,15.0013
1,1,0,3,4.92,50,2011,1,15.0013
3,2,1,4,4.1,54,2011,1,8.9981
3,3,0,5,4.1,54,2011,1,16.9979
31,31,0,6,4.92,50,2011,1,19.0012
77,75,2,7,4.92,50,2011,1,15.0013
188,184,4,8,4.92,50,2011,1,19.0012
94,92,2,9,5.74,50,2011,1,16.9979
31,31,0,10,5.74,50,2011,1,19.9995
30,28,2,11,6.56,47,2011,1,19.0012
52,47,5,12,8.2,40,2011,1,19.0012
54,50,4,13,8.2,40,2011,1,19.0012
47,47,0,14,8.2,40,2011,1,15.0013
45,43,2,15,8.2,40,2011,1,15.0013
74,70,4,16,8.2,40,2011,1,8.9981
178,174,4,17,8.2,40,2011,1,7.0015
155,154,1,18,8.2,40,2011,1,15.0013
95,92,3,19,6.56,47,2011,1,11.0014
74,73,1,20,6.56,50,2011,1,11.0014
38,37,1,21,5.74,59,2011,1,12.998
24,22,2,22,5.74,59,2011,1,11.0014
18,18,0,23,5.74,59,2011,1,11.0014
12,10,2,0,5.74,59,2011,1,7.0015
3,3,0,1,5.74,59,2011,1,11.0014
3,3,0,2,6.56,55,2011,1,12.998
6,6,0,5,6.56,55,2011,1,8.9981
27,27,0,6,6.56,55,2011,1,8.9981
99,97,2,7,6.56,55,2011,1,7.163459348
217,214,3,8,7.38,51,2011,1,6.0032
130,127,3,9,7.38,51,2011,1,11.0014
54,51,3,10,8.2,51,2011,1,11.0014
35,31,4,11,8.2,47,2011,1,8.9981
57,55,2,12,8.2,51,2011,1,7.0015
52,46,6,13,8.2,59,2011,1,6.0032
63,60,3,14,8.2,59,2011,1,6.0032
47,45,2,15,6.56,80,2011,1,6.0032
76,72,4,16,6.56,86,2011,1,15.0013
136,130,6,17,6.56,86,2011,1,15.0013
95,94,1,18,6.56,93,2011,1,7.0015
51,51,0,19,6.56,93,2011,1,6.840148118
32,32,0,20,6.56,93,2011,1,12.998
20,20,0,21,6.56,86,2011,1,6.0032
29,28,1,22,6.56,93,2011,1,7.0015
19,18,1,23,6.56,93,2011,1,6.0032
7,7,0,0,6.56,86,2011,1,6.0032
6,6,0,1,6.56,86,2011,1,7.0015
1,1,0,2,5.74,86,2011,1,8.9981
5,5,0,5,5.74,86,2011,1,11.0014
16,16,0,6,4.92,93,2011,1,8.9981
54,54,0,7,5.74,69,2011,1,8.9981
128,125,3,8,6.56,59,2011,1,11.0014
81,78,3,9,6.56,59,2011,1,22.0028
39,39,0,10,7.38,55,2011,1,15.0013
35,32,3,11,8.2,51,2011,1,26.0027
55,52,3,12,8.2,47,2011,1,39.0007
49,49,0,13,9.02,44,2011,1,23.9994
44,44,0,14,8.2,47,2011,1,22.0028
49,48,1,15,8.2,47,2011,1,27.9993
68,63,5,16,9.02,44,2011,1,22.0028
139,139,0,17,8.2,47,2011,1,23.9994
137,135,2,18,8.2,47,2011,1,35.0008
83,82,1,19,7.38,47,2011,1,27.9993
56,54,2,20,6.56,50,2011,1,22.0028
57,57,0,21,6.56,55,2011,1,22.0028
33,32,1,22,6.56,55,2011,1,30.0026
20,19,1,23,5.74,59,2011,1,27.9993
7,6,1,0,5.74,59,2011,1,19.0012
2,2,0,1,5.74,50,2011,1,19.0012
2,2,0,2,5.74,50,2011,1,23.9994
3,3,0,3,5.74,50,2011,1,22.0028
4,4,0,4,5.74,50,2011,1,16.9979
3,3,0,5,5.74,50,2011,1,19.9995
28,28,0,6,4.92,54,2011,1,8.9981
72,72,0,7,4.92,54,2011,1,8.9981
202,197,5,8,5.74,50,2011,1,12.998
139,137,2,9,5.74,50,2011,1,22.0028
38,36,2,10,6.56,50,2011,1,23.9994
37,33,4,11,8.2,44,2011,1,30.0026
52,49,3,12,8.2,44,2011,1,27.9993
83,81,2,13,9.02,41,2011,1,30.0026
42,39,3,14,9.02,41,2011,1,26.0027
60,55,5,15,9.84,38,2011,1,19.9995
78,76,2,16,9.84,38,2011,1,23.9994
162,158,4,17,8.2,40,2011,1,19.0012
144,141,3,18,8.2,40,2011,1,22.0028
99,98,1,19,6.56,47,2011,1,16.9979
64,64,0,20,6.56,47,2011,1,15.0013
40,40,0,21,5.74,46,2011,1,19.9995
30,30,0,22,5.74,46,2011,1,22.0028
15,14,1,23,4.92,50,2011,1,12.998
14,14,0,0,4.92,50,2011,1,12.998
5,5,0,1,4.1,54,2011,1,11.0014
1,1,0,2,4.1,54,2011,1,8.9981
1,1,0,3,4.1,54,2011,1,7.0015
8,8,0,5,4.1,54,2011,1,6.0032
17,17,0,6,4.1,54,2011,1,8.013489918
70,70,0,7,4.1,74,2011,1,11.0014
158,156,2,8,4.92,68,2011,1,9.976667916
117,117,0,9,5.74,69,2011,1,8.9981
44,40,4,10,7.38,55,2011,1,12.998
53,47,6,11,7.38,51,2011,1,19.0012
61,59,2,12,8.2,44,2011,1,16.9979
77,73,4,13,9.02,37,2011,1,26.0027
64,59,5,14,9.02,41,2011,1,19.0012
68,59,9,15,9.84,38,2011,1,11.0014
90,87,3,16,9.02,41,2011,1,7.0015
159,155,4,17,9.02,41,2011,1,11.0014
139,134,5,18,8.2,47,2011,1,7.35927759
92,89,3,19,6.56,59,2011,1,6.0032
68,68,0,20,7.38,59,2011,1,7.239782114
52,48,4,21,6.56,69,2011,1,8.272886809
36,34,2,22,6.56,69,2011,1,8.743562626
27,26,1,23,7.38,55,2011,1,7.28945845
28,25,3,0,7.38,55,2011,1,7.303871106
20,18,2,1,6.56,59,2011,1,6.0032
12,12,0,2,6.56,59,2011,1,6.0032
8,7,1,3,6.56,59,2011,1,6.956104503
5,5,0,4,6.56,59,2011,1,6.956104503
1,1,0,5,6.56,59,2011,1,6.969592506
3,2,1,6,5.74,63,2011,1,7.0015
10,9,1,7,5.74,63,2011,1,7.623392515
23,22,1,8,5.74,63,2011,1,8.9981
33,31,2,9,6.56,64,2011,1,8.9981
59,57,2,10,7.38,59,2011,1,11.0014
72,54,18,11,8.2,55,2011,1,15.0013
89,74,15,12,9.84,48,2011,1,15.0013
101,80,21,13,11.48,38,2011,1,19.9995
118,92,26,14,12.3,39,2011,1,19.0012
129,108,21,15,13.12,36,2011,1,12.998
128,95,33,16,13.94,34,2011,1,12.998
83,54,29,17,13.12,36,2011,1,19.0012
84,69,15,18,12.3,45,2011,1,16.9979
74,60,14,19,13.12,39,2011,1,16.9979
41,35,6,20,13.12,39,2011,1,16.9979
57,51,6,21,13.12,39,2011,1,15.0013
26,26,0,22,12.3,42,2011,1,7.0015
44,39,5,23,12.3,45,2011,1,19.0012
39,33,6,0,10.66,56,2011,1,7.874928844
23,19,4,1,10.66,56,2011,1,8.9981
16,13,3,2,10.66,56,2011,1,6.0032
15,6,9,3,9.02,69,2011,1,9.053337219
1,1,0,4,10.66,56,2011,1,11.0014
2,1,1,5,10.66,56,2011,1,11.0014
1,1,0,6,10.66,56,2011,1,11.0014
3,3,0,7,9.84,56,2011,1,19.9995
18,18,0,8,9.02,55,2011,1,19.0012
32,29,3,9,9.02,51,2011,1,16.9979
79,71,8,10,9.02,51,2011,1,19.0012
93,70,23,11,9.84,44,2011,1,16.9979
104,75,29,12,9.84,41,2011,1,19.0012
118,95,23,13,10.66,35,2011,1,19.9995
91,69,22,14,11.48,36,2011,1,16.9979
113,78,35,15,10.66,38,2011,1,16.9979
99,77,22,16,9.84,38,2011,1,15.0013
105,82,23,17,9.02,37,2011,1,16.9979
67,56,11,18,8.2,40,2011,1,11.0014
61,47,14,19,7.38,47,2011,1,8.9981
57,50,7,20,7.38,47,2011,1,11.0014
28,22,6,21,7.38,51,2011,1,11.0014
21,19,2,22,8.2,49,2011,1,8.9981
18,18,0,23,8.2,40,2011,1,7.0015
17,16,1,0,8.2,47,2011,1,15.0013
16,15,1,1,8.2,44,2011,1,12.998
8,8,0,2,7.38,43,2011,1,16.9979
2,2,0,3,7.38,43,2011,1,12.998
3,2,1,4,7.38,43,2011,1,8.9981
1,1,0,5,7.38,43,2011,1,11.0014
5,5,0,6,7.38,43,2011,1,12.998
13,9,4,7,6.56,50,2011,1,8.9981
33,30,3,8,6.56,47,2011,1,15.0013
47,39,8,9,6.56,47,2011,1,15.0013
57,50,7,10,6.56,50,2011,1,16.9979
64,55,9,11,6.56,55,2011,1,12.998
80,70,10,12,7.38,47,2011,1,8.9981
93,80,13,13,7.38,47,2011,1,8.9981
86,74,12,14,7.38,43,2011,1,7.0015
93,72,21,15,8.2,47,2011,1,11.0014
82,76,6,16,8.2,47,2011,1,11.0014
71,67,4,17,8.2,51,2011,1,12.998
92,85,7,18,7.38,55,2011,1,16.9979
60,58,2,19,7.38,59,2011,1,12.998
33,29,4,20,6.56,80,2011,1,12.998
27,24,3,21,6.56,80,2011,1,12.998
13,13,0,22,5.74,93,2011,1,16.9979
4,3,1,23,6.56,86,2011,1,19.0012
3,3,0,12,8.2,86,2011,1,22.0028
22,22,0,13,8.2,86,2011,1,15.0013
28,26,2,14,9.02,80,2011,1,11.0014
35,32,3,15,9.02,87,2011,1,11.0014
61,61,0,16,9.02,87,2011,1,12.998
125,124,1,17,9.02,82,2011,1,12.998
133,132,1,18,9.02,80,2011,1,11.0014
99,98,1,19,9.02,80,2011,1,8.9981
83,83,0,20,9.02,87,2011,1,8.867520292
41,41,0,21,9.02,93,2011,1,7.0015
33,33,0,22,9.02,93,2011,1,6.0032
20,19,1,23,9.02,93,2011,1,8.860221786
3,3,0,0,9.02,93,2011,1,8.860221786
7,6,1,1,9.02,93,2011,1,8.9981
3,3,0,2,9.02,93,2011,1,8.9981
2,1,1,4,9.02,93,2011,1,8.9981
7,7,0,5,9.02,93,2011,1,6.0032
32,32,0,6,9.02,93,2011,1,6.0032
90,89,1,7,9.84,92,2011,1,7.0015
197,196,1,8,9.84,93,2011,1,7.0015
109,107,2,9,9.84,93,2011,1,7.0015
47,46,1,10,10.66,93,2011,1,8.9981
52,47,5,11,11.48,87,2011,1,6.0032
70,65,5,12,12.3,81,2011,1,6.0032
78,67,11,13,16.4,62,2011,1,19.0012
75,68,7,14,16.4,58,2011,1,16.9979
82,78,4,15,16.4,54,2011,1,19.0012
104,94,10,16,15.58,58,2011,1,26.0027
197,190,7,17,14.76,57,2011,1,22.0028
161,156,5,18,13.94,61,2011,1,19.0012
112,108,4,19,13.12,57,2011,1,27.9993
76,74,2,20,13.12,49,2011,1,19.9995
59,55,4,21,13.12,49,2011,1,27.9993
59,53,6,22,12.3,52,2011,1,11.0014
28,27,1,23,12.3,52,2011,1,31.0009
8,6,2,0,6.56,64,2011,1,7.0015
3,3,0,1,6.56,69,2011,1,7.0015
2,2,0,2,6.56,69,2011,1,8.909935789
2,2,0,3,6.56,69,2011,1,8.909935789
3,3,0,5,5.74,93,2011,1,8.073690522
22,22,0,6,5.74,93,2011,1,8.073690522
52,52,0,7,6.56,93,2011,1,6.949576225
135,132,3,8,6.56,93,2011,1,6.949576225
116,114,2,9,6.56,93,2011,1,10.09320768
47,47,0,10,6.56,93,2011,1,10.09320768
51,49,2,11,7.38,86,2011,1,9.790090035
55,53,2,12,8.2,86,2011,1,9.78313186
52,49,3,13,8.2,86,2011,1,9.78313186
54,49,5,14,9.02,80,2011,1,6.0032
52,45,7,15,9.84,75,2011,1,10.10532513
64,61,3,16,9.84,75,2011,1,8.9981
176,172,4,17,9.84,75,2011,1,10.10532513
168,165,3,18,9.84,81,2011,1,7.0015
108,105,3,19,9.84,81,2011,1,8.9981
74,69,5,20,9.02,87,2011,1,8.9981
64,64,0,21,9.02,87,2011,1,8.9981
36,34,2,22,9.02,87,2011,1,6.0032
16,15,1,23,8.2,93,2011,1,12.998
2,2,0,0,9.02,93,2011,1,7.0015
3,3,0,1,9.02,93,2011,1,12.998
4,0,4,2,9.02,93,2011,1,8.9981
1,1,0,3,9.02,93,2011,1,8.9981
1,1,0,4,9.02,93,2011,1,19.0012
3,3,0,5,9.02,93,2011,1,7.0015
18,17,1,6,9.02,93,2011,1,7.0015
49,48,1,7,9.02,93,2011,1,15.0013
155,154,1,8,9.02,93,2011,1,15.0013
123,119,4,9,9.84,93,2011,1,6.0032
61,59,2,10,9.02,100,2011,1,10.90162704
52,47,5,11,9.84,93,2011,1,12.998
64,61,3,12,9.84,93,2011,1,15.0013
75,74,1,13,13.94,93,2011,1,11.0014
63,61,2,14,15.58,82,2011,1,26.0027
76,66,10,15,15.58,76,2011,1,22.0028
103,95,8,16,14.76,71,2011,1,19.9995
190,183,7,17,14.76,53,2011,1,35.0008
182,175,7,18,13.94,42,2011,1,36.9974
91,88,3,19,11.48,45,2011,1,32.9975
75,71,4,20,9.84,48,2011,1,36.9974
63,62,1,21,9.02,47,2011,1,22.0028
40,35,5,22,9.02,44,2011,1,16.9979
32,29,3,23,8.2,44,2011,1,30.0026
12,11,1,0,8.2,40,2011,1,30.0026
5,5,0,1,8.2,44,2011,1,35.0008
2,2,0,2,7.38,43,2011,1,16.9979
1,1,0,3,7.38,43,2011,1,16.9979
2,2,0,5,6.56,50,2011,1,19.9995
39,39,0,6,6.56,43,2011,1,23.9994
87,86,1,7,5.74,50,2011,1,22.0028
188,184,4,8,5.74,50,2011,1,23.9994
133,127,6,9,6.56,47,2011,1,19.9995
52,50,2,10,7.38,43,2011,1,22.0028
64,55,9,11,7.38,43,2011,1,30.0026
69,67,2,12,8.2,40,2011,1,23.9994
51,47,4,13,8.2,40,2011,1,27.9993
47,43,4,14,9.02,37,2011,1,26.0027
60,56,4,15,9.02,37,2011,1,22.0028
78,73,5,16,9.02,37,2011,1,16.9979
175,170,5,17,8.2,40,2011,1,12.998
147,145,2,18,8.2,40,2011,1,11.0014
96,92,4,19,8.2,40,2011,1,6.931390311
109,108,1,20,8.2,47,2011,1,6.0032
54,53,1,21,7.38,55,2011,1,7.0015
41,39,2,22,7.38,51,2011,1,6.0032
38,34,4,23,8.2,47,2011,1,7.0015
13,10,3,0,8.2,44,2011,1,7.337562595
7,7,0,1,6.56,59,2011,1,7.028687211
1,1,0,2,5.74,63,2011,1,7.0015
1,1,0,3,5.74,63,2011,1,7.0015
7,7,0,5,5.74,63,2011,1,8.9981
28,26,2,6,6.56,55,2011,1,7.214139004
87,87,0,7,5.74,59,2011,1,7.713639912
220,217,3,8,5.74,74,2011,1,8.9981
127,124,3,9,6.56,80,2011,1,8.9981
51,46,5,10,8.2,51,2011,1,8.9981
64,61,3,11,9.02,51,2011,1,11.0014
86,78,8,12,9.84,48,2011,1,11.0014
82,73,9,13,10.66,50,2011,1,15.0013
91,76,15,14,11.48,45,2011,1,11.0014
90,81,9,15,11.48,48,2011,1,16.9979
99,91,8,16,12.3,42,2011,1,15.0013
205,195,10,17,10.66,56,2011,1,8.9981
155,152,3,18,9.84,60,2011,1,7.0015
103,102,1,19,9.84,65,2011,1,8.9981
71,69,2,20,9.84,65,2011,1,11.0014
43,41,2,21,9.84,70,2011,1,11.0014
46,45,1,22,9.84,65,2011,1,11.0014
31,30,1,23,9.84,70,2011,1,8.9981
39,36,3,0,9.84,70,2011,1,11.0014
18,17,1,1,9.84,65,2011,1,11.0014
17,12,5,2,9.84,75,2011,1,11.0014
11,10,1,3,9.84,75,2011,1,11.0014
8,8,0,4,9.02,93,2011,1,8.9981
9,9,0,5,8.2,100,2011,1,6.0032
4,4,0,6,8.2,100,2011,1,7.568981574
4,4,0,7,9.02,93,2011,1,6.0032
10,10,0,8,8.2,100,2011,1,6.0032
20,17,3,9,8.2,100,2011,1,6.0032
34,31,3,10,8.2,100,2011,1,8.9981
47,46,1,11,9.02,100,2011,1,8.9981
52,42,10,12,9.02,100,2011,1,11.0014
72,62,10,13,9.02,100,2011,1,11.0014
55,50,5,14,9.02,100,2011,1,8.035814152
60,49,11,15,9.02,100,2011,1,8.035814152
71,63,8,16,9.02,100,2011,1,8.9981
78,64,14,17,9.84,100,2011,1,19.0012
83,81,2,18,11.48,93,2011,1,30.0026
84,78,6,19,11.48,93,2011,1,30.0026
69,64,5,20,12.3,87,2011,1,16.9979
56,53,3,21,10.66,100,2011,1,12.998
45,43,2,22,10.66,93,2011,1,8.9981
59,52,7,23,10.66,93,2011,1,15.0013
39,37,2,0,10.66,70,2011,1,12.998
44,40,4,1,10.66,65,2011,1,27.9993
20,20,0,2,10.66,60,2011,1,22.0028
13,10,3,3,10.66,60,2011,1,6.0032
2,2,0,4,10.66,60,2011,1,23.9994
1,1,0,5,10.66,60,2011,1,15.0013
1,1,0,6,10.66,60,2011,1,15.0013
8,8,0,7,9.84,65,2011,1,11.0014
23,21,2,8,9.84,65,2011,1,7.0015
45,38,7,9,11.48,56,2011,1,7.0015
89,74,15,10,12.3,52,2011,1,16.9979
117,89,28,11,13.12,49,2011,1,16.9979
174,126,48,12,13.94,46,2011,1,13.30353845
182,135,47,13,13.94,46,2011,1,11.05778612
161,114,47,14,13.94,46,2011,1,6.0032
182,130,52,15,13.94,46,2011,1,6.0032
157,115,42,16,13.94,49,2011,1,7.0015
121,97,24,17,13.94,46,2011,1,11.05778612
78,65,13,18,12.3,56,2011,1,11.0014
21,20,1,19,11.48,61,2011,1,8.9981
26,21,5,20,11.48,61,2011,1,7.0015
27,22,5,21,10.66,60,2011,1,8.137031714
62,57,5,22,10.66,60,2011,1,8.137031714
30,26,4,23,9.84,65,2011,1,9.213814468
15,14,1,0,9.84,65,2011,1,9.213814468
5,4,1,1,9.02,75,2011,1,9.791621628
3,3,0,2,8.2,80,2011,1,9.678818005
1,1,0,3,8.2,86,2011,1,9.730891908
2,1,1,4,8.2,86,2011,1,9.730891908
10,9,1,5,8.2,86,2011,1,9.730891908
30,29,1,6,7.38,93,2011,1,9.61701228
95,89,6,7,7.38,86,2011,1,9.55301357
230,223,7,8,6.56,100,2011,1,10.94549558
118,115,3,9,9.02,80,2011,1,9.971160393
55,49,6,10,9.84,75,2011,1,7.0015
47,36,11,11,12.3,65,2011,1,6.0032
66,59,7,12,13.12,62,2011,1,11.95213294
64,54,10,13,14.76,57,2011,1,6.0032
60,52,8,14,14.76,57,2011,1,6.0032
50,46,4,15,15.58,54,2011,1,6.0032
114,98,16,16,14.76,57,2011,1,8.9981
216,207,9,17,13.12,70,2011,1,11.0014
175,170,5,18,13.94,66,2011,1,8.9981
128,123,5,19,13.12,70,2011,1,11.95505319
88,82,6,20,13.12,70,2011,1,7.0015
78,75,3,21,13.12,70,2011,1,11.80831812
37,34,3,22,11.48,81,2011,1,6.0032
25,19,6,23,12.3,81,2011,1,12.2398197
10,6,4,0,11.48,87,2011,1,12.17750594
4,4,0,1,11.48,87,2011,1,12.17750594
2,1,1,2,10.66,93,2011,1,7.0015
1,1,0,3,11.48,93,2011,1,11.0014
3,3,0,4,10.66,93,2011,1,11.0014
2,2,0,5,10.66,81,2011,1,22.0028
39,39,0,6,10.66,70,2011,1,22.0028
100,97,3,7,9.84,65,2011,1,27.9993
243,236,7,8,9.84,56,2011,1,32.9975
135,128,7,9,9.84,52,2011,1,32.9975
48,44,4,10,9.02,47,2011,1,36.9974
50,49,1,11,9.02,47,2011,1,31.0009
65,63,2,12,9.84,38,2011,1,32.9975
50,48,2,13,9.84,32,2011,1,30.0026
64,61,3,14,9.02,37,2011,1,27.9993
51,45,6,15,9.02,35,2011,1,26.0027
83,79,4,16,9.02,35,2011,1,35.0008
176,172,4,17,9.02,32,2011,1,39.0007
152,151,1,18,8.2,32,2011,1,26.0027
101,100,1,19,6.56,40,2011,1,31.0009
56,53,3,20,6.56,40,2011,1,22.0028
54,46,8,21,5.74,33,2011,1,31.0009
29,29,0,22,4.92,33,2011,1,23.9994
12,9,3,23,4.92,33,2011,1,22.0028
17,17,0,0,4.1,36,2011,1,23.9994
7,7,0,1,4.1,36,2011,1,15.0013
3,2,1,2,3.28,38,2011,1,19.0012
2,2,0,3,2.46,45,2011,1,8.9981
7,7,0,5,2.46,45,2011,1,7.0015
43,43,0,6,2.46,45,2011,1,10.493484
99,95,4,7,2.46,49,2011,1,7.0015
199,198,1,8,4.1,42,2011,1,15.58159646
123,119,4,9,4.92,39,2011,1,11.0014
59,51,8,10,5.74,36,2011,1,13.42905525
41,40,1,11,5.74,43,2011,1,11.0014
61,57,4,12,7.38,40,2011,1,15.0013
69,67,2,13,7.38,40,2011,1,16.9979
58,56,2,14,8.2,34,2011,1,19.9995
64,61,3,15,8.2,34,2011,1,19.0012
79,72,7,16,8.2,37,2011,1,16.9979
166,157,9,17,8.2,34,2011,1,16.9979
170,168,2,18,7.38,47,2011,1,19.9995
88,87,1,19,5.74,86,2011,1,16.9979
84,84,0,20,5.74,86,2011,1,11.0014
83,83,0,21,5.74,86,2011,1,11.0014
46,42,4,22,6.56,80,2011,1,11.0014
37,37,0,23,6.56,80,2011,1,12.998
16,16,0,0,5.74,86,2011,1,12.998
7,7,0,1,5.74,80,2011,1,8.9981
3,3,0,2,5.74,80,2011,1,8.9981
1,1,0,4,5.74,59,2011,1,15.0013
6,6,0,5,4.92,50,2011,1,15.0013
26,26,0,6,4.92,54,2011,1,19.0012
99,99,0,7,4.1,50,2011,1,27.9993
178,173,5,8,4.1,49,2011,1,22.0028
122,121,1,9,4.92,42,2011,1,23.9994
35,34,1,10,4.92,42,2011,1,19.9995
45,44,1,11,5.74,39,2011,1,23.9994
69,65,4,12,6.56,34,2011,1,26.0027
62,59,3,13,7.38,29,2011,1,19.9995
48,42,6,14,8.2,27,2011,1,19.0012
50,50,0,15,8.2,25,2011,1,16.9979
80,76,4,16,8.2,27,2011,1,19.9995
165,159,6,17,7.38,26,2011,1,12.998
160,157,3,18,6.56,28,2011,1,8.9981
112,110,2,19,5.74,28,2011,1,7.0015
97,93,4,20,5.74,31,2011,1,6.0032
72,70,2,21,5.74,39,2011,1,10.23372128
51,47,4,22,4.92,39,2011,1,11.62528892
34,33,1,23,4.92,42,2011,1,7.0015
14,12,2,0,4.1,49,2011,1,7.0015
7,6,1,1,4.1,54,2011,1,6.0032
3,3,0,2,4.1,54,2011,1,6.0032
4,4,0,5,3.28,63,2011,1,6.0032
24,23,1,6,4.1,68,2011,1,9.642918007
74,73,1,7,3.28,73,2011,1,10.25011845
216,212,4,8,4.1,74,2011,1,11.0014
140,132,8,9,4.92,74,2011,1,15.0013
44,39,5,10,5.74,69,2011,1,12.998
64,52,12,11,9.02,47,2011,1,8.9981
71,64,7,12,9.02,47,2011,1,8.9981
110,89,21,13,9.84,35,2011,1,12.998
84,67,17,14,12.3,26,2011,1,16.9979
74,62,12,15,13.12,21,2011,1,11.0014
125,111,14,16,12.3,28,2011,1,12.998
211,193,18,17,12.3,24,2011,1,9.261506995
174,165,9,18,11.48,28,2011,1,9.923209265
101,94,7,19,10.66,33,2011,1,11.72232736
63,61,2,20,9.02,55,2011,1,8.9981
47,46,1,21,8.2,59,2011,1,8.9981
43,41,2,22,8.2,64,2011,1,6.0032
53,48,5,23,7.38,69,2011,1,8.465698745
30,27,3,0,6.56,69,2011,1,6.0032
24,22,2,1,5.74,86,2011,1,9.787743247
15,13,2,2,5.74,80,2011,1,9.677427123
10,7,3,3,4.92,80,2011,1,9.702396891
4,4,0,4,4.92,74,2011,1,6.0032
1,1,0,5,4.92,74,2011,1,6.0032
2,1,1,6,4.92,93,2011,1,12.998
11,9,2,7,4.92,80,2011,1,7.0015
30,28,2,8,5.74,86,2011,1,8.9981
43,38,5,9,6.56,64,2011,1,8.9981
84,71,13,10,9.02,41,2011,1,16.9979
114,84,30,11,12.3,28,2011,1,22.0028
120,93,27,12,12.3,39,2011,1,31.0009
135,103,32,13,12.3,39,2011,1,27.9993
120,90,30,14,13.94,31,2011,1,19.0012
174,127,47,15,13.94,29,2011,1,27.9993
145,103,42,16,13.94,29,2011,1,27.9993
137,113,24,17,13.12,31,2011,1,35.0008
64,60,4,18,11.48,38,2011,1,22.0028
41,39,2,19,11.48,38,2011,1,11.0014
40,39,1,20,10.66,41,2011,1,15.0013
51,42,9,21,10.66,41,2011,1,11.52070434
45,39,6,22,9.84,44,2011,1,6.0032
32,31,1,23,9.02,51,2011,1,8.9981
39,34,5,0,8.2,64,2011,1,7.0015
24,23,1,1,8.2,59,2011,1,6.0032
20,19,1,2,8.2,75,2011,1,6.0032
12,8,4,3,8.2,69,2011,1,7.0015
2,2,0,4,8.2,69,2011,1,11.0014
5,3,2,6,8.2,69,2011,1,8.9981
3,3,0,7,9.02,55,2011,1,7.168674927
12,11,1,8,9.02,64,2011,1,12.998
47,35,12,9,9.84,60,2011,1,15.0013
105,86,19,10,12.3,45,2011,1,22.0028
112,86,26,11,13.12,39,2011,1,30.0026
152,94,58,12,14.76,32,2011,1,31.0009
154,92,62,13,15.58,29,2011,1,23.9994
161,110,51,14,16.4,30,2011,1,27.9993
162,122,40,15,16.4,30,2011,1,19.9995
134,106,28,16,17.22,28,2011,1,22.0028
125,95,30,17,17.22,28,2011,1,22.0028
95,78,17,18,16.4,32,2011,1,19.9995
61,50,11,19,16.4,35,2011,1,19.0012
47,32,15,20,16.4,35,2011,1,22.0028
51,45,6,21,16.4,35,2011,1,23.9994
36,31,5,22,16.4,35,2011,1,19.9995
30,27,3,23,16.4,35,2011,1,23.9994
11,8,3,0,15.58,37,2011,1,23.9994
7,6,1,1,15.58,37,2011,1,23.9994
2,2,0,2,14.76,40,2011,1,19.9995
2,1,1,3,13.94,46,2011,1,15.0013
2,2,0,4,13.12,53,2011,1,19.0012
3,3,0,5,13.12,53,2011,1,19.0012
26,25,1,6,13.94,46,2011,1,19.9995
98,96,2,7,13.94,46,2011,1,19.9995
256,249,7,8,15.58,40,2011,1,31.0009
130,122,8,9,16.4,37,2011,1,26.0027
55,46,9,10,18.04,33,2011,1,15.0013
53,43,10,11,21.32,23,2011,1,16.9979
126,99,27,12,22.96,22,2011,1,30.0026
120,93,27,13,23.78,19,2011,1,26.0027
90,76,14,14,24.6,15,2011,1,32.9975
90,71,19,15,22.96,21,2011,1,43.9989
118,102,16,16,21.32,27,2011,1,31.0009
243,218,25,17,18.86,33,2011,1,40.9973
205,194,11,18,16.4,40,2011,1,40.9973
98,86,12,19,15.58,43,2011,1,32.9975
70,65,5,20,14.76,46,2011,1,31.0009
43,35,8,21,14.76,50,2011,1,35.0008
45,44,1,22,13.94,46,2011,1,43.9989
20,19,1,23,13.12,49,2011,1,32.9975
19,12,7,0,12.3,49,2011,1,27.9993
5,5,0,1,12.3,42,2011,1,51.9987
3,2,1,2,11.48,41,2011,1,46.0022
1,1,0,4,9.02,37,2011,1,35.0008
4,4,0,5,9.02,32,2011,1,31.0009
30,30,0,6,8.2,32,2011,1,22.0028
105,103,2,7,8.2,32,2011,1,23.9994
223,213,10,8,8.2,32,2011,1,23.9994
110,108,2,9,9.02,29,2011,1,30.0026
52,47,5,10,9.84,27,2011,1,19.0012
57,46,11,11,10.66,25,2011,1,16.9979
71,65,6,12,11.48,24,2011,1,16.9979
82,68,14,13,13.12,21,2011,1,15.0013
79,69,10,14,13.94,19,2011,1,15.0013
85,74,11,15,13.94,19,2011,1,11.0014
98,77,21,16,13.94,19,2011,1,16.9979
206,191,15,17,13.12,22,2011,1,15.0013
212,198,14,18,12.3,22,2011,1,8.9981
145,142,3,19,11.48,26,2011,1,8.9981
101,98,3,20,10.66,33,2011,1,7.0015
66,61,5,21,9.84,52,2011,1,9.210015649
41,41,0,22,9.84,44,2011,1,9.86081066
20,20,0,23,9.02,44,2011,1,6.0032
15,15,0,0,9.02,41,2011,1,6.0032
9,9,0,1,8.2,44,2011,1,6.0032
1,1,0,3,8.2,47,2011,1,12.998
1,1,0,4,8.2,51,2011,1,12.998
5,5,0,5,8.2,47,2011,1,12.998
33,32,1,6,8.2,55,2011,1,15.0013
108,103,5,7,8.2,55,2011,1,15.0013
230,224,6,8,9.02,55,2011,1,11.0014
124,122,2,9,9.84,52,2011,1,19.0012
69,55,14,10,10.66,41,2011,1,26.0027
66,59,7,11,13.94,34,2011,1,19.9995
86,72,14,12,15.58,32,2011,1,22.0028
93,80,13,13,17.22,30,2011,1,23.9994
82,65,17,14,18.86,28,2011,1,27.9993
117,82,35,15,18.86,28,2011,1,27.9993
122,96,26,16,18.86,31,2011,1,26.0027
255,244,11,17,18.86,28,2011,1,19.0012
222,202,20,18,16.4,40,2011,1,15.0013
161,143,18,19,13.94,53,2011,1,15.0013
118,108,10,20,15.58,43,2011,1,12.998
92,87,5,21,14.76,46,2011,1,12.998
73,61,12,22,13.94,53,2011,1,12.998
33,31,2,23,15.58,40,2011,1,15.0013
17,16,1,0,13.94,53,2011,1,12.998
6,6,0,1,13.94,53,2011,1,15.0013
6,4,2,2,13.94,53,2011,1,15.0013
4,1,3,3,13.94,53,2011,1,12.998
4,1,3,4,13.12,57,2011,1,12.998
12,11,1,5,13.12,66,2011,1,6.0032
47,44,3,6,12.3,70,2011,1,8.9981
126,119,7,7,13.12,57,2011,1,7.0015
285,267,18,8,13.12,57,2011,1,6.0032
179,163,16,9,14.76,57,2011,1,12.998
88,70,18,10,15.58,54,2011,1,12.998
90,71,19,11,18.04,44,2011,1,16.9979
101,86,15,12,19.68,41,2011,1,15.0013
123,108,15,13,22.14,34,2011,1,15.0013
81,55,26,14,24.6,31,2011,1,15.0013
106,91,15,15,24.6,28,2011,1,16.9979
146,117,29,16,22.96,35,2011,1,19.9995
274,256,18,17,23.78,32,2011,1,19.9995
222,211,11,18,22.14,42,2011,1,19.0012
175,161,14,19,19.68,55,2011,1,22.0028
139,131,8,20,19.68,59,2011,1,22.0028
124,119,5,21,21.32,55,2011,1,26.0027
76,68,8,22,20.5,59,2011,1,19.0012
44,40,4,23,18.86,67,2011,1,19.9995
32,20,12,0,18.04,72,2011,1,19.0012
8,7,1,1,18.04,72,2011,1,15.0013
7,5,2,2,18.04,72,2011,1,19.0012
8,6,2,3,18.86,67,2011,1,16.9979
1,1,0,4,18.86,67,2011,1,16.9979
7,6,1,5,18.86,67,2011,1,7.0015
50,48,2,6,18.04,72,2011,1,11.0014
116,108,8,7,17.22,77,2011,1,15.0013
272,246,26,8,17.22,77,2011,1,12.998
169,154,15,9,17.22,77,2011,1,12.998
95,78,17,10,18.04,72,2011,1,15.0013
113,82,31,11,18.04,72,2011,1,11.0014
185,126,59,12,20.5,59,2011,1,12.998
176,131,45,13,24.6,43,2011,1,12.998
191,118,73,14,27.06,36,2011,1,19.9995
172,117,55,15,27.06,36,2011,1,22.0028
232,164,68,16,27.06,36,2011,1,19.0012
327,275,52,17,27.06,34,2011,1,23.9994
224,195,29,18,26.24,33,2011,1,22.0028
162,146,16,19,25.42,29,2011,1,39.0007
124,105,19,20,24.6,31,2011,1,12.998
72,61,11,21,23.78,21,2011,1,32.9975
107,88,19,22,22.14,10,2011,1,16.9979
77,61,16,23,21.32,8,2011,1,19.0012
29,23,6,0,19.68,12,2011,1,32.9975
31,21,10,1,18.86,14,2011,1,27.9993
17,14,3,2,18.04,13,2011,1,26.0027
7,7,0,3,17.22,14,2011,1,19.9995
3,3,0,4,16.4,15,2011,1,22.0028
3,3,0,5,16.4,15,2011,1,22.0028
6,3,3,6,16.4,17,2011,1,27.9993
22,16,6,7,15.58,17,2011,1,35.0008
45,36,9,8,15.58,17,2011,1,39.0007
55,37,18,9,16.4,16,2011,1,43.9989
106,72,34,10,17.22,16,2011,1,39.0007
123,76,47,11,18.04,16,2011,1,39.0007
119,81,38,12,18.04,18,2011,1,32.9975
155,103,52,13,18.04,16,2011,1,40.9973
196,94,102,14,18.86,15,2011,1,43.9989
171,87,84,15,18.04,16,2011,1,50.0021
120,81,39,16,18.04,16,2011,1,43.0006
127,91,36,17,17.22,19,2011,1,40.9973
88,67,21,18,14.76,25,2011,1,30.0026
59,54,5,19,13.94,29,2011,1,23.9994
47,38,9,20,13.12,28,2011,1,35.0008
33,29,4,21,13.12,26,2011,1,36.9974
44,42,2,22,12.3,28,2011,1,32.9975
29,25,4,23,11.48,33,2011,1,30.0026
7,7,0,0,12.3,70,2011,1,31.0009
3,3,0,1,10.66,70,2011,1,23.9994
4,4,0,2,9.84,65,2011,1,26.0027
2,2,0,3,9.02,69,2011,1,19.0012
1,1,0,4,9.02,69,2011,1,16.9979
2,1,1,5,8.2,64,2011,1,19.0012
46,46,0,6,8.2,59,2011,1,19.9995
107,105,2,7,8.2,59,2011,1,22.0028
214,204,10,8,8.2,59,2011,1,26.0027
124,116,8,9,9.02,55,2011,1,27.9993
68,55,13,10,9.84,52,2011,1,19.0012
56,48,8,11,11.48,45,2011,1,16.9979
86,80,6,12,12.3,39,2011,1,8.9981
78,65,13,13,13.12,39,2011,1,9.795306587
79,61,18,14,13.12,36,2011,1,8.9981
64,57,7,15,13.94,34,2011,1,8.642749911
102,92,10,16,13.94,34,2011,1,6.0032
242,230,12,17,13.94,34,2011,1,6.0032
224,214,10,18,13.12,39,2011,1,12.998
119,115,4,19,12.3,49,2011,1,8.9981
88,86,2,20,12.3,61,2011,1,6.0032
63,55,8,21,10.66,56,2011,1,8.071224131
47,44,3,22,9.84,62,2011,1,7.0015
25,23,2,23,9.84,65,2011,1,15.0013
8,5,3,0,9.02,69,2011,1,11.0014
4,4,0,1,9.02,69,2011,1,12.998
2,2,0,2,9.02,69,2011,1,12.998
4,1,3,3,9.02,69,2011,1,19.0012
1,0,1,4,8.2,75,2011,1,8.9981
5,5,0,5,9.02,69,2011,1,15.0013
40,39,1,6,9.02,55,2011,1,16.9979
110,108,2,7,9.02,64,2011,1,16.9979
256,243,13,8,9.84,65,2011,1,19.0012
148,141,7,9,11.48,56,2011,1,19.9995
76,65,11,10,13.12,49,2011,1,19.0012
73,65,8,11,13.94,53,2011,1,22.0028
82,62,20,12,16.4,43,2011,1,12.998
125,90,35,13,20.5,25,2011,1,23.54918804
96,75,21,14,21.32,23,2011,1,19.9995
110,91,19,15,22.14,19,2011,1,27.9993
139,112,27,16,22.14,19,2011,1,22.0028
268,238,30,17,20.5,23,2011,1,19.0012
201,193,8,18,18.86,23,2011,1,32.9975
150,144,6,19,16.4,28,2011,1,35.0008
95,86,9,20,14.76,29,2011,1,27.9993
71,68,3,21,13.94,29,2011,1,31.0009
48,44,4,22,12.3,26,2011,1,36.9974
22,22,0,23,10.66,30,2011,1,35.0008
13,10,3,0,9.84,30,2011,1,31.0009
1,1,0,1,9.84,30,2011,1,31.0009
3,2,1,2,8.2,27,2011,1,31.0009
1,1,0,3,8.2,27,2011,1,31.0009
1,1,0,4,6.56,31,2011,1,32.9975
8,7,1,5,5.74,33,2011,1,19.9995
35,34,1,6,5.74,33,2011,1,19.9995
111,110,1,7,4.92,42,2011,1,27.9993
220,216,4,8,5.74,39,2011,1,19.9995
145,135,10,9,6.56,37,2011,1,19.0012
56,49,7,10,7.38,29,2011,1,12.998
50,40,10,11,8.2,29,2011,1,6.0032
72,65,7,12,9.02,25,2011,1,8.9981
80,67,13,13,9.02,25,2011,1,6.0032
78,60,18,14,9.84,21,2011,1,7.0015
68,62,6,15,9.84,23,2011,1,9.822545148
71,65,6,16,10.66,23,2011,1,11.76208833
202,185,17,17,10.66,22,2011,1,11.65402731
167,161,6,18,9.84,35,2011,1,22.0028
106,101,5,19,8.2,40,2011,1,16.9979
70,69,1,20,8.2,40,2011,1,6.0032
51,48,3,21,7.38,40,2011,1,7.0015
53,50,3,22,8.2,40,2011,1,6.901736294
23,23,0,23,7.38,43,2011,1,6.0032
12,12,0,0,8.2,55,2011,1,12.998
4,4,0,1,7.38,64,2011,1,12.998
2,2,0,2,7.38,64,2011,1,12.998
1,1,0,3,7.38,74,2011,1,16.9979
1,0,1,4,7.38,74,2011,1,12.998
7,7,0,5,6.56,74,2011,1,8.9981
29,28,1,6,6.56,74,2011,1,6.0032
83,83,0,7,6.56,80,2011,1,8.9981
228,222,6,8,7.38,74,2011,1,8.9981
150,138,12,9,9.02,60,2011,1,8.9981
66,56,10,10,9.84,60,2011,1,16.9979
89,73,16,11,11.48,52,2011,1,15.0013
97,87,10,12,13.12,43,2011,1,11.0014
87,74,13,13,13.94,42,2011,1,15.0013
95,65,30,14,14.76,40,2011,1,19.0012
106,75,31,15,14.76,40,2011,1,19.9995
118,101,17,16,14.76,46,2011,1,12.998
228,206,22,17,14.76,50,2011,1,16.9979
187,172,15,18,13.94,53,2011,1,19.9995
107,102,5,19,13.12,61,2011,1,16.9979
87,78,9,20,12.3,70,2011,1,12.998
70,64,6,21,12.3,70,2011,1,15.0013
44,40,4,22,12.3,70,2011,1,12.998
46,40,6,23,12.3,75,2011,1,11.0014
19,15,4,0,11.48,81,2011,1,7.0015
25,20,5,1,12.3,81,2011,1,7.0015
20,15,5,2,12.3,87,2011,1,12.998
2,2,0,3,12.3,87,2011,1,12.998
1,1,0,4,12.3,93,2011,1,11.0014
3,3,0,5,12.3,100,2011,1,8.9981
4,3,1,6,12.3,100,2011,1,15.0013
15,10,5,7,12.3,100,2011,1,19.9995
45,34,11,8,12.3,100,2011,1,19.9995
63,48,15,9,13.12,93,2011,1,15.0013
103,69,34,10,13.94,93,2011,1,12.998
159,116,43,11,16.4,76,2011,1,15.0013
167,121,46,12,18.04,67,2011,1,16.9979
190,130,60,13,18.86,67,2011,1,19.0012
198,118,80,14,19.68,59,2011,1,19.0012
205,122,83,15,18.86,63,2011,1,19.9995
204,130,74,16,19.68,59,2011,1,19.9995
164,104,60,17,19.68,59,2011,1,23.9994
152,115,37,18,19.68,59,2011,1,22.0028
89,62,27,19,18.86,67,2011,1,22.0028
70,58,12,20,18.04,77,2011,1,22.0028
72,60,12,21,18.04,72,2011,1,22.0028
63,47,16,22,17.22,77,2011,1,19.9995
44,34,10,23,18.04,77,2011,1,19.9995
52,41,11,0,17.22,77,2011,1,23.9994
39,27,12,1,17.22,77,2011,1,19.0012
32,27,5,2,16.4,82,2011,1,19.0012
11,9,2,3,17.22,82,2011,1,19.9995
3,3,0,4,17.22,88,2011,1,23.9994
2,1,1,6,17.22,94,2011,1,23.9994
5,5,0,7,17.22,100,2011,1,30.0026
9,8,1,8,16.4,100,2011,1,19.9995
22,18,4,9,17.22,100,2011,1,19.0012
31,27,4,10,17.22,100,2011,1,19.9995
62,44,18,11,17.22,100,2011,1,15.0013
79,69,10,12,18.86,94,2011,1,22.0028
105,83,22,13,18.86,94,2011,1,23.9994
39,27,12,14,18.04,100,2011,1,15.0013
7,4,3,15,18.04,100,2011,1,15.0013
11,8,3,16,14.76,100,2011,1,19.0012
25,23,2,17,13.94,100,2011,1,19.9995
23,23,0,18,13.12,100,2011,1,23.9994
11,11,0,19,12.3,100,2011,1,32.9975
11,8,3,20,11.48,100,2011,1,27.9993
7,6,1,21,9.84,93,2011,1,40.9973
10,10,0,22,9.02,100,2011,1,26.0027
9,9,0,23,9.02,100,2011,1,27.9993
4,4,0,0,8.2,100,2011,1,22.0028
2,2,0,1,8.2,100,2011,1,22.0028
1,1,0,3,8.2,80,2011,1,39.0007
1,0,1,4,8.2,80,2011,1,35.0008
1,1,0,5,8.2,75,2011,1,23.9994
34,31,3,6,8.2,75,2011,1,26.0027
91,88,3,7,8.2,75,2011,1,27.9993
211,200,11,8,8.2,75,2011,1,26.0027
134,129,5,9,9.02,64,2011,1,31.0009
58,43,15,10,9.84,60,2011,1,19.9995
60,41,19,11,10.66,48,2011,1,30.0026
96,68,28,12,12.3,42,2011,1,27.9993
70,54,16,13,13.12,36,2011,1,26.0027
77,56,21,14,13.12,36,2011,1,27.9993
96,64,32,15,13.94,31,2011,1,26.0027
122,96,26,16,13.94,31,2011,1,23.9994
233,206,27,17,13.94,29,2011,1,23.9994
233,214,19,18,13.12,31,2011,1,15.0013
145,134,11,19,12.3,33,2011,1,15.0013
92,87,5,20,12.3,33,2011,1,11.0014
54,53,1,21,11.48,38,2011,1,15.0013
35,34,1,22,10.66,48,2011,1,11.0014
22,22,0,23,11.48,48,2011,1,10.06188995
10,9,1,0,10.66,48,2011,1,6.0032
4,4,0,1,9.84,52,2011,1,8.9981
1,0,1,2,9.84,52,2011,1,8.9981
7,2,5,3,9.84,52,2011,1,6.0032
2,2,0,4,9.02,64,2011,1,8.791025118
10,8,2,5,8.2,69,2011,1,7.0015
45,42,3,6,8.2,59,2011,1,6.96870141
128,119,9,7,7.38,64,2011,1,8.9981
257,247,10,8,9.02,55,2011,1,12.998
151,140,11,9,10.66,41,2011,1,11.0014
71,46,25,10,12.3,33,2011,1,12.998
78,52,26,11,14.76,25,2011,1,11.0014
99,70,29,12,14.76,23,2011,1,13.66369914
98,73,25,13,15.58,25,2011,1,7.0015
72,56,16,14,15.58,20,2011,1,17.42872888
112,77,35,15,14.76,18,2011,1,13.69749312
108,82,26,16,15.58,27,2011,1,11.0014
248,209,39,17,14.76,27,2011,1,15.0013
235,214,21,18,13.94,27,2011,1,12.998
150,141,9,19,13.94,31,2011,1,7.0015
76,74,2,20,13.12,39,2011,1,6.0032
75,68,7,21,12.3,49,2011,1,12.998
55,44,11,22,12.3,49,2011,1,15.0013
41,38,3,23,11.48,61,2011,1,12.998
9,9,0,0,10.66,65,2011,1,6.0032
4,4,0,1,10.66,52,2011,1,8.9981
2,1,1,2,10.66,52,2011,1,8.9981
3,2,1,3,9.84,70,2011,1,6.0032
2,2,0,4,9.84,75,2011,1,7.0015
8,7,1,5,9.84,81,2011,1,8.9981
49,44,5,6,9.84,85,2011,1,7.0015
141,123,18,7,9.84,87,2011,1,11.0014
249,238,11,8,9.84,87,2011,1,8.9981
141,136,5,9,10.66,87,2011,1,16.9979
57,49,8,10,12.3,75,2011,1,16.9979
59,44,15,11,13.12,76,2011,1,26.0027
98,84,14,12,13.12,76,2011,1,16.9979
99,82,17,13,13.12,76,2011,1,23.9994
71,61,10,14,13.94,76,2011,1,19.9995
79,64,15,15,14.76,71,2011,1,19.9995
112,102,10,16,13.94,76,2011,1,22.0028
194,176,18,17,13.94,76,2011,1,19.9995
188,176,12,18,13.94,76,2011,1,16.9979
134,123,11,19,13.94,76,2011,1,22.0028
91,87,4,20,13.12,87,2011,1,12.998
62,52,10,21,13.12,93,2011,1,22.0028
21,17,4,22,13.12,93,2011,1,11.0014
18,17,1,23,13.94,93,2011,1,12.998
3,0,3,0,13.94,0,2011,1,16.9979
2,2,0,1,13.94,0,2011,1,16.9979
1,1,0,2,13.94,0,2011,1,16.9979
3,2,1,5,14.76,0,2011,1,12.998
12,12,0,6,14.76,0,2011,1,22.0028
37,36,1,7,15.58,0,2011,1,15.0013
44,43,1,8,15.58,0,2011,1,19.0012
24,23,1,9,16.4,0,2011,1,15.0013
17,17,0,10,16.4,0,2011,1,11.0014
11,5,6,11,16.4,0,2011,1,16.9979
34,30,4,12,17.22,0,2011,1,15.0013
12,11,1,13,17.22,0,2011,1,15.0013
12,12,0,14,18.04,0,2011,1,19.9995
14,11,3,15,18.04,0,2011,1,15.0013
21,20,1,16,17.22,0,2011,1,16.9979
111,109,2,17,18.04,0,2011,1,26.0027
82,80,2,18,18.04,0,2011,1,23.9994
56,51,5,19,18.04,0,2011,1,39.0007
38,29,9,20,14.76,0,2011,1,22.0028
28,27,1,21,14.76,0,2011,1,15.0013
34,30,4,22,13.94,0,2011,1,8.9981
27,26,1,23,13.94,0,2011,1,6.0032
6,6,0,0,13.94,100,2011,1,6.0032
8,8,0,1,13.94,100,2011,1,7.0015
5,3,2,2,13.94,100,2011,1,7.0015
2,2,0,3,13.12,93,2011,1,6.0032
7,6,1,5,12.3,81,2011,1,15.0013
32,31,1,6,10.66,81,2011,1,19.0012
114,104,10,7,10.66,70,2011,1,12.998
259,244,15,8,11.48,70,2011,1,16.9979
156,143,13,9,12.3,61,2011,1,19.0012
78,60,18,10,13.12,57,2011,1,19.9995
81,67,14,11,13.12,57,2011,1,19.9995
111,96,15,12,13.94,53,2011,1,16.9979
107,92,15,13,14.76,53,2011,1,16.9979
89,64,25,14,14.76,50,2011,1,23.9994
85,64,21,15,13.94,53,2011,1,16.9979
113,95,18,16,13.94,49,2011,1,19.9995
223,200,23,17,13.94,49,2011,1,15.0013
153,134,19,18,13.12,49,2011,1,22.0028
118,111,7,19,12.3,56,2011,1,22.0028
76,70,6,20,12.3,56,2011,1,11.0014
53,43,10,21,12.3,52,2011,1,16.9979
64,53,11,22,12.3,52,2011,1,11.0014
37,34,3,23,12.3,52,2011,1,16.9979
34,30,4,0,10.66,60,2011,1,8.9981
18,15,3,1,9.84,65,2011,1,12.998
14,14,0,2,9.84,65,2011,1,12.998
7,6,1,3,9.84,65,2011,1,16.9979
1,1,0,4,9.84,65,2011,1,16.9979
2,2,0,5,9.02,69,2011,1,12.998
4,2,2,6,9.02,75,2011,1,16.9979
23,19,4,7,9.84,70,2011,1,12.998
53,44,9,8,10.66,65,2011,1,11.0014
101,76,25,9,11.48,65,2011,1,7.0015
99,78,21,10,13.12,66,2011,1,15.0013
119,83,36,11,13.94,49,2011,1,22.0028
158,107,51,12,13.94,53,2011,1,19.0012
157,95,62,13,14.76,51,2011,1,23.9994
166,96,70,14,16.4,50,2011,1,30.0026
182,101,81,15,17.22,44,2011,1,32.9975
244,144,100,16,18.86,41,2011,1,30.0026
213,114,99,17,18.86,44,2011,1,22.0028
145,91,54,18,17.22,54,2011,1,11.0014
112,86,26,19,17.22,54,2011,1,6.0032
86,64,22,20,16.4,58,2011,1,7.0015
82,46,36,21,15.58,62,2011,1,14.34956167
63,56,7,22,14.76,71,2011,1,13.09966975
49,38,11,23,15.58,66,2011,1,6.0032
38,35,3,0,15.58,62,2011,1,7.0015
33,23,10,1,14.76,66,2011,1,8.9981
23,17,6,3,13.94,76,2011,1,8.9981
13,9,4,4,13.94,66,2011,1,11.0014
3,3,0,5,14.76,62,2011,1,8.9981
2,2,0,6,13.94,66,2011,1,11.79803905
10,8,2,7,14.76,62,2011,1,12.998
34,23,11,8,16.4,50,2011,1,19.9995
44,36,8,9,16.4,50,2011,1,27.9993
122,86,36,10,17.22,47,2011,1,16.9979
181,93,88,11,18.04,41,2011,1,27.9993
194,120,74,12,18.86,38,2011,1,26.0027
221,124,97,13,18.86,38,2011,1,26.0027
250,106,144,14,18.86,41,2011,1,19.9995
304,155,149,15,19.68,39,2011,1,22.0028
256,132,124,16,18.86,41,2011,1,26.0027
241,143,98,17,18.04,41,2011,1,23.9994
147,92,55,18,16.4,43,2011,1,23.9994
101,73,28,19,14.76,50,2011,1,23.9994
77,54,23,20,13.12,57,2011,1,19.9995
58,49,9,21,12.3,56,2011,1,16.9979
37,29,8,22,12.3,56,2011,1,22.0028
28,23,5,23,10.66,65,2011,1,15.0013
11,7,4,0,10.66,65,2011,1,7.0015
1,1,0,1,10.66,65,2011,1,6.0032
1,1,0,2,10.66,65,2011,1,6.0032
3,3,0,3,10.66,65,2011,1,8.9981
8,8,0,5,9.84,70,2011,1,8.9981
28,27,1,6,10.66,65,2011,1,8.9981
88,84,4,7,11.48,61,2011,1,10.36959984
241,217,24,8,12.3,56,2011,1,8.9981
140,127,13,9,13.12,53,2011,1,22.0028
84,57,27,10,13.94,42,2011,1,16.9979
71,45,26,11,14.76,40,2011,1,16.9979
94,54,40,12,15.58,37,2011,1,19.30010714
75,51,24,13,15.58,36,2011,1,22.0028
79,52,27,14,15.58,34,2011,1,18.82351971
101,77,24,15,15.58,37,2011,1,11.0014
107,80,27,16,16.4,35,2011,1,7.0015
271,229,42,17,15.58,40,2011,1,12.998
235,210,25,18,14.76,40,2011,1,7.0015
150,133,17,19,14.76,43,2011,1,8.9981
129,106,23,20,13.94,46,2011,1,15.0013
63,58,5,21,13.94,46,2011,1,8.9981
47,43,4,22,13.12,49,2011,1,7.0015
19,17,2,23,13.12,53,2011,1,10.18228295
14,7,7,0,13.12,53,2011,1,10.18228295
10,6,4,1,12.3,62,2011,1,6.0032
3,2,1,2,12.3,62,2011,1,6.0032
2,1,1,4,9.84,75,2011,1,6.0032
11,11,0,5,9.84,75,2011,1,12.998
35,32,3,6,9.02,80,2011,1,12.998
119,109,10,7,9.84,75,2011,1,11.0014
282,259,23,8,10.66,70,2011,1,6.0032
157,147,10,9,12.3,70,2011,1,11.89434367
78,56,22,10,13.12,66,2011,1,12.998
78,51,27,11,13.94,57,2011,1,15.0013
102,70,32,12,14.76,50,2011,1,15.0013
97,74,23,13,14.76,57,2011,1,19.0012
88,74,14,14,15.58,46,2011,1,19.9995
90,66,24,15,15.58,43,2011,1,19.0012
114,93,21,16,15.58,46,2011,1,22.0028
217,195,22,17,14.76,62,2011,1,12.998
225,207,18,18,14.76,62,2011,1,19.9995
152,138,14,19,13.94,71,2011,1,19.0012
88,79,9,20,13.94,71,2011,1,19.0012
55,53,2,21,13.12,81,2011,1,7.0015
21,20,1,22,13.12,87,2011,1,11.0014
18,17,1,23,13.12,87,2011,1,11.0014
8,8,0,0,12.3,93,2011,1,16.9979
3,2,1,1,12.3,100,2011,1,19.9995
3,2,1,3,11.48,100,2011,1,15.0013
1,1,0,4,12.3,93,2011,1,11.0014
3,3,0,5,12.3,93,2011,1,7.0015
31,30,1,6,12.3,93,2011,1,7.0015
111,101,10,7,12.3,93,2011,1,12.998
253,227,26,8,13.12,93,2011,1,13.12319266
154,144,10,9,13.12,93,2011,1,8.9981
68,49,19,10,14.76,81,2011,1,11.0014
75,62,13,11,14.76,81,2011,1,8.9981
88,65,23,12,16.4,71,2011,1,7.0015
99,81,18,13,16.4,76,2011,1,8.9981
100,67,33,14,16.4,76,2011,1,15.0013
101,79,22,15,16.4,76,2011,1,16.9979
151,121,30,16,16.4,76,2011,1,11.0014
253,216,37,17,18.04,54,2011,1,19.9995
237,211,26,18,18.04,54,2011,1,15.0013
168,150,18,19,18.04,51,2011,1,22.0028
121,111,10,20,17.22,54,2011,1,19.9995
78,75,3,21,17.22,58,2011,1,19.0012
59,48,11,22,16.4,62,2011,1,26.0027
27,18,9,23,16.4,65,2011,1,12.998
23,19,4,0,15.58,66,2011,1,16.9979
12,11,1,1,14.76,71,2011,1,15.0013
8,5,3,2,13.94,71,2011,1,19.9995
2,1,1,3,13.94,66,2011,1,11.0014
3,3,0,4,13.94,71,2011,1,12.998
13,13,0,5,13.12,76,2011,1,7.0015
51,47,4,6,13.12,76,2011,1,12.998
140,128,12,7,13.12,76,2011,1,8.9981
299,282,17,8,14.76,66,2011,1,8.9981
185,162,23,9,16.4,62,2011,1,16.9979
78,69,9,10,18.04,54,2011,1,22.0028
86,66,20,11,18.04,54,2011,1,19.0012
105,81,24,12,20.5,45,2011,1,15.0013
111,85,26,13,21.32,42,2011,1,6.0032
119,87,32,14,20.5,45,2011,1,7.0015
125,95,30,15,21.32,42,2011,1,16.9979
142,108,34,16,20.5,48,2011,1,19.0012
313,265,48,17,20.5,42,2011,1,12.998
310,260,50,18,18.86,59,2011,1,11.0014
207,189,18,19,18.04,58,2011,1,12.998
137,112,25,20,17.22,67,2011,1,15.0013
138,119,19,21,17.22,62,2011,1,15.0013
87,70,17,22,16.4,66,2011,1,15.0013
50,43,7,23,17.22,62,2011,1,19.0012
29,24,5,0,17.22,58,2011,1,19.0012
16,12,4,1,16.4,62,2011,1,16.9979
14,9,5,2,16.4,62,2011,1,12.998
5,4,1,3,14.76,71,2011,1,12.998
10,8,2,5,15.58,66,2011,1,11.0014
36,35,1,6,16.4,66,2011,1,12.998
123,112,11,7,16.4,66,2011,1,12.998
280,256,24,8,17.22,67,2011,1,16.9979
210,192,18,9,18.86,63,2011,1,15.0013
117,74,43,10,21.32,53,2011,1,19.0012
159,104,55,11,22.14,52,2011,1,19.0012
195,123,72,12,22.96,49,2011,1,23.9994
175,118,57,13,26.24,41,2011,1,19.0012
174,103,71,14,27.06,39,2011,1,16.9979
173,111,62,15,27.88,39,2011,1,23.9994
204,137,67,16,27.88,39,2011,1,19.0012
332,237,95,17,28.7,37,2011,1,22.0028
331,247,84,18,27.88,39,2011,1,11.0014
190,132,58,19,27.06,44,2011,1,8.9981
149,103,46,20,25.42,46,2011,1,8.9981
113,91,22,21,25.42,46,2011,1,7.0015
118,63,55,22,25.42,50,2011,1,11.0014
86,60,26,23,24.6,53,2011,1,15.0013
76,50,26,0,24.6,53,2011,1,16.9979
51,35,16,1,23.78,46,2011,1,23.9994
25,20,5,2,22.96,43,2011,1,15.0013
8,7,1,3,22.14,39,2011,1,22.0028
3,2,1,4,21.32,34,2011,1,27.9993
2,2,0,5,21.32,34,2011,1,27.9993
10,10,0,6,18.04,44,2011,1,27.9993
13,9,4,7,16.4,50,2011,1,22.0028
48,37,11,8,17.22,47,2011,1,32.9975
76,41,35,9,17.22,44,2011,1,31.0009
140,85,55,10,18.04,38,2011,1,27.9993
196,106,90,11,18.86,36,2011,1,30.0026
267,141,126,12,18.86,33,2011,1,27.9993
301,127,174,13,20.5,34,2011,1,31.0009
312,144,168,14,20.5,31,2011,1,32.9975
313,143,170,15,20.5,29,2011,1,27.9993
304,129,175,16,20.5,31,2011,1,26.0027
278,140,138,17,19.68,31,2011,1,22.0028
217,125,92,18,18.86,31,2011,1,22.0028
154,116,38,19,18.04,33,2011,1,19.0012
108,69,39,20,17.22,35,2011,1,15.0013
93,73,20,21,16.4,37,2011,1,19.9995
72,45,27,22,16.4,37,2011,1,22.0028
50,37,13,23,15.58,40,2011,1,19.9995
6,6,0,0,10.66,100,2011,2,11.0014
4,4,0,1,10.66,100,2011,2,11.0014
7,7,0,2,10.66,93,2011,2,12.998
4,4,0,3,9.84,93,2011,2,16.9979
3,3,0,4,9.84,93,2011,2,16.9979
12,11,1,5,9.84,93,2011,2,15.0013
28,26,2,6,9.84,93,2011,2,15.0013
95,91,4,7,9.84,93,2011,2,14.39655158
206,198,8,8,10.66,87,2011,2,16.9979
173,162,11,9,13.12,70,2011,2,23.9994
75,63,12,10,13.12,66,2011,2,19.0012
89,72,17,11,13.12,61,2011,2,23.9994
95,80,15,12,13.94,53,2011,2,23.9994
110,92,18,13,14.76,50,2011,2,23.9994
87,61,26,14,14.76,46,2011,2,23.9994
111,81,30,15,13.94,46,2011,2,27.9993
167,125,42,16,13.94,46,2011,2,27.9993
281,245,36,17,13.94,46,2011,2,22.0028
241,205,36,18,13.94,46,2011,2,22.0028
136,120,16,19,13.94,49,2011,2,22.0028
77,75,2,20,13.12,53,2011,2,12.998
93,84,9,21,13.12,53,2011,2,8.9981
74,64,10,22,12.3,56,2011,2,11.0014
53,41,12,23,12.3,61,2011,2,6.0032
32,29,3,0,12.3,61,2011,2,11.10499462
32,28,4,1,10.66,65,2011,2,8.9981
21,20,1,2,9.84,75,2011,2,8.9981
9,8,1,3,9.84,70,2011,2,11.0014
5,5,0,4,9.84,70,2011,2,11.0014
5,4,1,5,9.84,75,2011,2,11.0014
12,7,5,6,10.66,70,2011,2,7.0015
18,16,2,7,10.66,70,2011,2,7.0015
55,45,10,8,12.3,70,2011,2,7.0015
87,65,22,9,13.94,66,2011,2,7.0015
154,113,41,10,14.76,57,2011,2,11.0014
198,126,72,11,16.4,47,2011,2,11.0014
184,100,84,12,13.12,81,2011,2,8.9981
137,81,56,13,13.94,81,2011,2,8.9981
190,93,97,14,13.12,76,2011,2,22.0028
136,64,72,15,13.94,76,2011,2,26.0027
196,85,111,16,15.58,62,2011,2,22.0028
184,95,89,17,15.58,54,2011,2,23.9994
179,110,69,18,15.58,54,2011,2,12.998
148,77,71,19,14.76,53,2011,2,23.9994
85,56,29,20,13.94,53,2011,2,19.0012
77,53,24,21,13.12,61,2011,2,16.9979
55,41,14,22,13.12,61,2011,2,19.9995
53,33,20,23,13.12,61,2011,2,11.0014
39,31,8,0,12.3,65,2011,2,12.998
34,26,8,1,12.3,61,2011,2,7.0015
24,19,5,2,10.66,70,2011,2,8.9981
11,8,3,3,12.3,61,2011,2,10.46726789
3,0,3,4,11.48,70,2011,2,6.0032
5,4,1,5,11.48,65,2011,2,15.0013
33,23,10,6,11.48,65,2011,2,12.998
33,20,13,7,13.12,57,2011,2,15.0013
62,44,18,8,13.94,57,2011,2,11.0014
142,74,68,9,14.76,50,2011,2,32.9975
215,104,111,10,16.4,43,2011,2,27.9993
243,104,139,11,17.22,41,2011,2,16.9979
313,147,166,12,18.04,38,2011,2,19.0012
367,148,219,13,18.04,33,2011,2,19.9995
349,109,240,14,18.86,31,2011,2,8.9981
292,118,174,15,18.86,33,2011,2,19.16201906
303,156,147,16,18.86,31,2011,2,12.998
274,126,148,17,18.86,28,2011,2,8.9981
172,101,71,18,18.86,31,2011,2,18.55988818
144,93,51,19,17.22,44,2011,2,12.998
79,55,24,20,17.22,41,2011,2,15.0013
45,37,8,21,17.22,44,2011,2,15.0013
36,29,7,22,16.4,43,2011,2,7.0015
31,22,9,23,16.4,50,2011,2,6.0032
6,5,1,0,16.4,50,2011,2,15.0013
11,4,7,1,16.4,56,2011,2,23.9994
2,1,1,2,15.58,66,2011,2,16.9979
1,0,1,3,15.58,66,2011,2,19.0012
2,1,1,4,15.58,71,2011,2,19.9995
7,7,0,5,16.4,62,2011,2,16.9979
46,43,3,6,17.22,58,2011,2,19.0012
157,150,7,7,18.04,54,2011,2,16.9979
339,308,31,8,18.86,55,2011,2,19.9995
158,134,24,9,20.5,51,2011,2,26.0027
90,55,35,10,22.14,45,2011,2,23.9994
124,66,58,11,24.6,40,2011,2,26.0027
157,98,59,12,26.24,36,2011,2,31.0009
139,92,47,13,27.88,34,2011,2,22.0028
123,76,47,14,30.34,27,2011,2,32.9975
143,96,47,15,31.16,23,2011,2,36.9974
189,130,59,16,31.16,22,2011,2,35.0008
366,283,83,17,30.34,23,2011,2,40.9973
386,308,78,18,29.52,23,2011,2,32.9975
278,227,51,19,28.7,24,2011,2,31.0009
173,133,40,20,28.7,24,2011,2,36.9974
95,76,19,21,28.7,30,2011,2,30.0026
75,58,17,22,27.88,36,2011,2,31.0009
48,30,18,23,26.24,47,2011,2,15.0013
22,12,10,0,25.42,50,2011,2,7.0015
15,5,10,1,25.42,57,2011,2,27.9993
5,5,0,2,22.14,73,2011,2,22.0028
4,3,1,3,22.14,73,2011,2,22.0028
2,2,0,4,20.5,88,2011,2,32.9975
5,5,0,5,18.86,94,2011,2,19.9995
38,36,2,6,19.68,88,2011,2,22.0028
134,124,10,7,19.68,88,2011,2,22.0028
157,148,9,8,15.58,87,2011,2,39.0007
46,44,2,9,14.76,87,2011,2,32.9975
28,25,3,10,13.94,81,2011,2,26.0027
19,18,1,11,13.12,81,2011,2,30.0026
38,32,6,12,13.94,71,2011,2,26.0027
56,51,5,13,14.76,63,2011,2,27.9993
76,67,9,14,14.76,57,2011,2,32.9975
68,62,6,15,16.4,46,2011,2,31.0009
130,113,17,16,15.58,46,2011,2,27.9993
273,246,27,17,17.22,38,2011,2,27.9993
267,248,19,18,15.58,40,2011,2,32.9975
160,148,12,19,14.76,43,2011,2,19.9995
91,87,4,20,13.94,46,2011,2,19.0012
89,81,8,21,13.94,46,2011,2,35.0008
46,43,3,22,13.12,49,2011,2,19.9995
26,23,3,23,12.3,49,2011,2,19.0012
15,15,0,0,12.3,49,2011,2,7.0015
2,2,0,1,10.66,60,2011,2,8.9981
5,5,0,2,9.84,70,2011,2,8.9981
4,4,0,3,10.66,60,2011,2,8.9981
1,1,0,4,9.84,65,2011,2,8.9981
13,12,1,5,9.84,70,2011,2,7.0015
56,52,4,6,9.84,70,2011,2,7.0015
133,130,3,7,10.66,65,2011,2,7.0015
325,308,17,8,13.12,61,2011,2,15.0013
165,157,8,9,14.76,46,2011,2,16.9979
69,48,21,10,16.4,37,2011,2,26.0027
93,70,23,11,17.22,38,2011,2,26.0027
134,112,22,12,18.04,41,2011,2,16.9979
112,83,29,13,18.86,38,2011,2,32.9975
115,80,35,14,20.5,34,2011,2,27.9993
117,83,34,15,21.32,32,2011,2,22.0028
169,142,27,16,22.14,28,2011,2,27.9993
356,303,53,17,21.32,32,2011,2,30.0026
325,282,43,18,21.32,29,2011,2,23.9994
232,196,36,19,20.5,31,2011,2,19.9995
141,126,15,20,18.86,51,2011,2,15.0013
102,84,18,21,18.86,41,2011,2,19.0012
84,71,13,22,18.86,41,2011,2,19.0012
40,29,11,23,18.86,41,2011,2,19.9995
20,15,5,0,18.86,41,2011,2,19.0012
13,11,2,1,17.22,47,2011,2,8.9981
7,7,0,2,17.22,54,2011,2,15.69973072
3,3,0,3,14.76,66,2011,2,12.998
1,1,0,4,13.94,76,2011,2,12.998
6,6,0,5,13.94,76,2011,2,15.0013
64,59,5,6,13.12,81,2011,2,16.9979
160,152,8,7,13.94,76,2011,2,11.0014
314,291,23,8,14.76,76,2011,2,12.998
170,155,15,9,16.4,66,2011,2,8.9981
95,66,29,10,17.22,67,2011,2,7.0015
122,86,36,11,18.86,55,2011,2,15.53648282
153,114,39,12,18.86,55,2011,2,15.53648282
135,99,36,13,21.32,48,2011,2,6.0032
157,111,46,14,22.96,43,2011,2,6.0032
160,133,27,15,24.6,38,2011,2,7.0015
213,161,52,16,24.6,35,2011,2,19.03489329
343,280,63,17,21.32,52,2011,2,19.0012
333,265,68,18,19.68,55,2011,2,16.9979
226,192,34,19,18.86,59,2011,2,19.9995
203,166,37,20,18.04,62,2011,2,11.0014
108,89,19,21,18.04,67,2011,2,19.0012
81,63,18,22,16.4,76,2011,2,12.998
54,45,9,23,15.58,76,2011,2,16.9979
25,21,4,0,14.76,76,2011,2,15.0013
9,6,3,1,13.94,76,2011,2,8.9981
13,10,3,2,13.94,76,2011,2,11.0014
1,1,0,3,13.94,76,2011,2,11.0014
1,1,0,4,13.94,86,2011,2,8.9981
9,8,1,5,13.12,87,2011,2,12.998
35,33,2,6,13.94,87,2011,2,11.6813016
113,109,4,7,13.94,87,2011,2,11.0014
221,208,13,8,13.94,87,2011,2,11.0014
185,168,17,9,14.76,76,2011,2,12.998
73,63,10,10,14.76,71,2011,2,19.0012
98,79,19,11,16.4,62,2011,2,26.0027
80,51,29,12,15.58,66,2011,2,15.0013
42,35,7,13,14.76,76,2011,2,19.0012
15,13,2,14,13.94,87,2011,2,15.0013
25,24,1,15,13.94,87,2011,2,15.0013
60,58,2,16,13.12,93,2011,2,16.9979
148,138,10,17,13.12,93,2011,2,16.9979
62,54,8,18,13.12,93,2011,2,16.9979
53,52,1,19,12.3,93,2011,2,27.9993
63,51,12,20,12.3,93,2011,2,22.0028
54,43,11,21,12.3,93,2011,2,16.9979
51,42,9,22,12.3,93,2011,2,19.9995
35,31,4,23,12.3,93,2011,2,15.0013
31,26,5,0,12.3,87,2011,2,15.0013
20,17,3,1,12.3,87,2011,2,8.9981
17,15,2,2,13.12,87,2011,2,15.0013
14,11,3,3,12.3,100,2011,2,16.9979
3,3,0,4,12.3,100,2011,2,16.9979
5,5,0,5,12.3,93,2011,2,15.0013
13,13,0,6,12.3,93,2011,2,12.998
21,13,8,7,12.3,93,2011,2,11.0014
54,47,7,8,13.12,93,2011,2,11.0014
98,71,27,9,13.94,87,2011,2,7.0015
133,90,43,10,13.94,87,2011,2,8.9981
142,91,51,11,14.76,81,2011,2,12.04300316
202,123,79,12,14.76,81,2011,2,8.9981
222,108,114,13,14.76,81,2011,2,12.84080035
212,118,94,14,14.76,81,2011,2,8.9981
201,116,85,15,14.76,87,2011,2,12.55010061
191,118,73,16,15.58,82,2011,2,13.53135377
257,129,128,17,15.58,82,2011,2,6.0032
177,129,48,18,15.58,82,2011,2,7.0015
130,83,47,19,15.58,82,2011,2,8.9981
93,74,19,20,15.58,87,2011,2,11.0014
75,65,10,21,14.76,93,2011,2,8.9981
87,66,21,22,14.76,93,2011,2,8.9981
57,45,12,23,15.58,87,2011,2,6.0032
53,48,5,0,15.58,87,2011,2,6.0032
37,31,6,1,15.58,87,2011,2,8.9981
36,24,12,2,15.58,87,2011,2,6.0032
16,11,5,3,15.58,87,2011,2,8.9981
5,2,3,4,14.76,93,2011,2,7.0015
4,4,0,5,14.76,93,2011,2,6.0032
4,4,0,6,14.76,93,2011,2,6.0032
10,7,3,7,14.76,100,2011,2,6.0032
55,38,17,8,15.58,94,2011,2,6.0032
81,50,31,9,15.58,94,2011,2,8.9981
150,81,69,10,16.4,87,2011,2,14.34695759
202,109,93,11,16.4,87,2011,2,8.9981
230,136,94,12,17.22,88,2011,2,8.9981
263,142,121,13,18.86,82,2011,2,7.0015
281,133,148,14,20.5,72,2011,2,12.998
297,141,156,15,20.5,77,2011,2,15.0013
288,153,135,16,21.32,72,2011,2,11.0014
236,152,84,17,21.32,72,2011,2,12.998
240,137,103,18,20.5,77,2011,2,12.998
131,84,47,19,20.5,77,2011,2,12.998
92,71,21,20,18.86,82,2011,2,8.9981
95,77,18,21,18.04,88,2011,2,12.998
57,45,12,22,18.04,94,2011,2,16.9979
32,27,5,23,18.86,88,2011,2,23.9994
23,16,7,0,19.68,88,2011,2,22.0028
4,3,1,1,18.86,94,2011,2,19.0012
9,2,7,2,18.86,94,2011,2,19.0012
1,1,0,4,18.86,94,2011,2,12.998
13,12,1,5,18.86,94,2011,2,12.998
61,59,2,6,18.86,100,2011,2,15.0013
176,164,12,7,20.5,88,2011,2,15.0013
314,286,28,8,21.32,88,2011,2,19.0012
165,132,33,9,22.96,83,2011,2,19.0012
96,55,41,10,22.96,83,2011,2,19.9995
104,59,45,11,24.6,73,2011,2,19.9995
134,97,37,12,24.6,73,2011,2,22.0028
139,77,62,13,26.24,69,2011,2,27.9993
145,85,60,14,29.52,54,2011,2,23.9994
141,85,56,15,30.34,48,2011,2,35.0008
235,162,73,16,30.34,48,2011,2,35.0008
452,352,100,17,30.34,48,2011,2,35.0008
383,290,93,18,29.52,51,2011,2,26.0027
284,211,73,19,29.52,51,2011,2,30.0026
166,122,44,20,27.88,57,2011,2,35.0008
158,119,39,21,27.06,61,2011,2,16.9979
91,66,25,22,26.24,50,2011,2,19.0012
54,38,16,23,23.78,60,2011,2,21.82047767
24,13,11,0,25.42,50,2011,2,7.0015
13,7,6,1,25.42,50,2011,2,6.0032
14,7,7,2,24.6,53,2011,2,8.9981
1,1,0,3,23.78,56,2011,2,8.9981
6,2,4,4,22.96,64,2011,2,8.9981
16,15,1,5,22.14,68,2011,2,8.9981
58,55,3,6,22.14,68,2011,2,19.0012
189,177,12,7,22.14,68,2011,2,15.0013
226,211,15,8,19.68,88,2011,2,26.0027
54,50,4,9,18.86,94,2011,2,32.9975
40,34,6,10,20.5,82,2011,2,27.9993
49,38,11,11,21.32,77,2011,2,23.9994
92,83,9,12,22.96,64,2011,2,31.0009
106,84,22,13,22.14,68,2011,2,19.0012
44,28,16,14,20.5,82,2011,2,19.0012
78,54,24,15,19.68,77,2011,2,35.0008
99,80,19,16,19.68,77,2011,2,26.0027
291,262,29,17,18.04,77,2011,2,15.0013
224,203,21,18,18.04,77,2011,2,15.0013
130,127,3,19,17.22,82,2011,2,19.0012
103,94,9,20,17.22,82,2011,2,19.0012
84,74,10,21,17.22,82,2011,2,12.998
54,47,7,22,16.4,94,2011,2,19.9995
39,31,8,23,16.4,94,2011,2,16.9979
15,12,3,0,16.4,100,2011,2,19.9995
1,1,0,1,16.4,100,2011,2,19.9995
2,2,0,2,16.4,100,2011,2,19.9995
2,2,0,3,16.4,94,2011,2,22.0028
3,2,1,4,16.4,94,2011,2,22.0028
5,4,1,5,15.58,94,2011,2,16.9979
34,33,1,6,15.58,94,2011,2,15.0013
70,67,3,7,14.76,100,2011,2,15.0013
164,158,6,8,15.58,94,2011,2,12.998
65,63,2,9,15.58,94,2011,2,15.0013
46,42,4,10,16.4,87,2011,2,12.998
61,57,4,11,17.22,82,2011,2,12.998
95,83,12,12,17.22,82,2011,2,16.9979
61,55,6,13,18.04,77,2011,2,12.998
106,82,24,14,17.22,77,2011,2,16.9979
81,69,12,15,18.04,72,2011,2,19.0012
142,119,23,16,18.86,67,2011,2,19.0012
309,284,25,17,18.86,67,2011,2,19.9995
321,293,28,18,18.04,62,2011,2,26.0027
175,160,15,19,18.04,62,2011,2,16.9979
126,119,7,20,18.04,62,2011,2,16.9979
117,100,17,21,17.22,67,2011,2,11.0014
99,89,10,22,17.22,67,2011,2,12.998
62,57,5,23,16.4,71,2011,2,8.9981
21,18,3,0,15.58,76,2011,2,8.9981
10,9,1,1,15.58,76,2011,2,15.0013
3,3,0,2,14.76,76,2011,2,8.9981
2,2,0,3,13.94,81,2011,2,8.9981
9,8,1,4,13.94,76,2011,2,11.45843724
14,12,2,5,13.94,76,2011,2,6.0032
70,66,4,6,13.94,76,2011,2,7.0015
193,182,11,7,15.58,66,2011,2,13.33734328
337,316,21,8,17.22,58,2011,2,11.0014
170,152,18,9,18.86,51,2011,2,8.9981
89,68,21,10,20.5,51,2011,2,12.998
115,87,28,11,21.32,45,2011,2,11.0014
145,110,35,12,22.14,42,2011,2,8.9981
159,121,38,13,22.96,37,2011,2,15.0013
137,101,36,14,22.96,35,2011,2,6.0032
142,85,57,15,24.6,31,2011,2,6.0032
202,153,49,16,24.6,26,2011,2,7.0015
388,338,50,17,24.6,28,2011,2,20.84365832
337,290,47,18,22.96,30,2011,2,21.10703642
259,222,37,19,22.14,32,2011,2,20.86955891
169,147,22,20,20.5,51,2011,2,12.998
145,126,19,21,18.86,63,2011,2,8.9981
104,82,22,22,19.68,55,2011,2,7.0015
47,40,7,23,18.86,59,2011,2,7.0015
27,21,6,0,18.04,67,2011,2,13.82490578
15,9,6,1,18.04,62,2011,2,14.69590579
18,10,8,2,16.4,76,2011,2,13.72560104
3,3,0,3,16.4,76,2011,2,13.72560104
3,3,0,4,15.58,82,2011,2,6.0032
13,11,2,5,14.76,81,2011,2,7.0015
47,42,5,6,14.76,81,2011,2,6.0032
149,139,10,7,16.4,71,2011,2,11.0014
300,279,21,8,18.04,62,2011,2,19.9995
178,162,16,9,20.5,55,2011,2,12.998
122,91,31,10,20.5,55,2011,2,12.998
136,95,41,11,21.32,55,2011,2,12.998
200,155,45,12,21.32,55,2011,2,19.0012
180,133,47,13,22.14,52,2011,2,16.9979
163,106,57,14,22.14,52,2011,2,16.9979
162,112,50,15,22.14,52,2011,2,30.0026
243,173,70,16,21.32,55,2011,2,32.9975
331,267,64,17,20.5,63,2011,2,26.0027
263,216,47,18,18.86,67,2011,2,26.0027
209,168,41,19,17.22,77,2011,2,26.0027
118,92,26,20,16.4,76,2011,2,22.0028
102,77,25,21,16.4,76,2011,2,19.9995
80,64,16,22,15.58,82,2011,2,26.0027
64,56,8,23,14.76,81,2011,2,12.998
43,36,7,0,14.76,81,2011,2,15.0013
33,28,5,1,14.76,87,2011,2,19.0012
24,19,5,2,14.76,87,2011,2,8.9981
14,9,5,3,14.76,87,2011,2,11.0014
5,4,1,4,14.76,87,2011,2,15.0013
4,3,1,5,15.58,87,2011,2,19.0012
10,9,1,6,16.4,82,2011,2,22.0028
21,18,3,7,16.4,82,2011,2,27.9993
45,38,7,8,16.4,87,2011,2,23.9994
29,27,2,9,16.4,100,2011,2,19.9995
22,21,1,10,17.22,94,2011,2,26.0027
31,27,4,11,17.22,94,2011,2,30.0026
32,26,6,12,18.86,88,2011,2,39.0007
58,49,9,13,18.86,94,2011,2,35.0008
63,49,14,14,21.32,83,2011,2,39.0007
78,62,16,15,21.32,83,2011,2,39.0007
33,27,6,16,20.5,88,2011,2,31.0009
15,14,1,17,20.5,88,2011,2,39.0007
38,32,6,18,20.5,94,2011,2,26.0027
71,62,9,19,21.32,94,2011,2,27.9993
53,49,4,20,18.04,94,2011,2,15.0013
14,13,1,21,18.04,94,2011,2,16.86883635
24,22,2,22,17.22,100,2011,2,17.48304791
35,30,5,23,18.04,77,2011,2,19.0012
33,29,4,0,18.04,77,2011,2,19.0012
31,25,6,1,17.22,67,2011,2,15.0013
29,25,4,2,16.4,62,2011,2,12.998
25,13,12,3,16.4,66,2011,2,8.9981
7,5,2,4,14.76,76,2011,2,7.0015
3,1,2,5,14.76,71,2011,2,11.0014
8,5,3,6,14.76,66,2011,2,30.0026
16,14,2,7,14.76,50,2011,2,23.9994
43,36,7,8,15.58,46,2011,2,26.0027
102,71,31,9,16.4,43,2011,2,19.0012
211,120,91,10,17.22,44,2011,2,30.0026
304,185,119,11,18.86,41,2011,2,27.9993
354,187,167,12,18.86,38,2011,2,26.0027
343,162,181,13,20.5,34,2011,2,26.0027
361,191,170,14,21.32,34,2011,2,26.0027
388,209,179,15,22.14,32,2011,2,35.0008
343,182,161,16,22.14,30,2011,2,23.9994
306,163,143,17,22.96,30,2011,2,30.0026
277,175,102,18,22.96,30,2011,2,26.0027
210,135,75,19,22.96,30,2011,2,19.9995
141,97,44,20,21.32,36,2011,2,12.998
83,70,13,21,20.5,42,2011,2,12.998
70,49,21,22,20.5,39,2011,2,7.0015
56,37,19,23,18.04,67,2011,2,11.0014
39,24,15,0,18.86,47,2011,2,6.0032
19,8,11,1,18.86,47,2011,2,8.9981
16,2,14,2,17.22,67,2011,2,7.0015
7,1,6,3,17.22,62,2011,2,7.0015
6,4,2,4,16.4,87,2011,2,11.0014
16,16,0,5,16.4,76,2011,2,6.0032
54,51,3,6,16.4,82,2011,2,13.63126351
168,156,12,7,18.86,63,2011,2,14.69114796
297,277,20,8,18.86,63,2011,2,14.69114796
169,132,37,9,20.5,55,2011,2,7.0015
109,68,41,10,21.32,55,2011,2,7.0015
123,87,36,11,22.14,52,2011,2,6.0032
184,124,60,12,22.96,49,2011,2,6.0032
169,128,41,13,22.96,49,2011,2,11.0014
144,95,49,14,23.78,49,2011,2,12.998
176,112,64,15,24.6,43,2011,2,12.998
205,165,40,16,24.6,46,2011,2,19.0012
428,362,66,17,23.78,49,2011,2,19.0012
362,321,41,18,26.24,31,2011,2,23.9994
286,244,42,19,22.96,46,2011,2,16.9979
165,136,29,20,24.6,33,2011,2,19.9995
151,131,20,21,22.96,37,2011,2,19.0012
90,81,9,22,21.32,55,2011,2,19.0012
46,35,11,23,20.5,59,2011,2,16.9979
25,23,2,0,20.5,55,2011,2,15.0013
7,2,5,1,18.86,63,2011,2,15.0013
13,5,8,2,18.86,67,2011,2,19.0012
3,3,0,3,19.68,63,2011,2,15.0013
5,4,1,4,18.86,67,2011,2,6.0032
18,17,1,5,18.86,72,2011,2,12.998
65,63,2,6,19.68,67,2011,2,15.54970974
188,166,22,7,21.32,55,2011,2,15.24104329
351,331,20,8,20.5,68,2011,2,8.9981
162,139,23,9,21.32,63,2011,2,6.0032
75,60,15,10,20.5,72,2011,2,15.0013
72,53,19,11,22.14,68,2011,2,11.0014
103,84,19,12,22.14,64,2011,2,6.0032
129,103,26,13,22.14,68,2011,2,15.0013
107,88,19,14,22.14,64,2011,2,12.998
127,83,44,15,22.14,65,2011,2,11.0014
192,162,30,16,22.96,52,2011,2,19.9995
411,372,39,17,22.96,60,2011,2,7.0015
421,377,44,18,22.14,64,2011,2,8.9981
276,248,28,19,20.5,72,2011,2,12.998
168,148,20,20,20.5,72,2011,2,15.0013
122,114,8,21,20.5,72,2011,2,8.9981
112,109,3,22,19.68,77,2011,2,6.0032
52,41,11,23,18.86,88,2011,2,6.0032
96,77,19,0,17.22,67,2011,2,6.0032
59,50,9,1,17.22,69,2011,2,7.0015
50,43,7,2,17.22,77,2011,2,7.0015
23,15,8,3,16.4,82,2011,2,7.0015
17,11,6,4,16.4,76,2011,2,7.0015
10,10,0,5,16.4,82,2011,2,6.0032
13,9,4,6,16.4,82,2011,2,6.0032
33,26,7,7,17.22,77,2011,2,6.0032
59,43,16,8,18.04,77,2011,2,8.9981
141,96,45,9,18.86,72,2011,2,8.9981
264,155,109,10,19.68,63,2011,2,12.998
250,141,109,11,18.86,82,2011,2,7.0015
281,172,109,12,19.68,77,2011,2,7.0015
332,209,123,13,20.5,63,2011,2,11.0014
238,153,85,14,20.5,68,2011,2,7.0015
266,153,113,15,20.5,72,2011,2,12.76767971
214,139,75,16,20.5,72,2011,2,12.998
196,136,60,17,19.68,82,2011,2,16.9979
159,126,33,18,18.86,82,2011,2,6.0032
178,131,47,19,18.86,84,2011,2,7.0015
121,86,35,20,18.86,82,2011,2,12.23693014
105,82,23,21,18.86,82,2011,2,12.23693014
100,68,32,22,18.86,82,2011,2,12.23693014
146,82,64,23,18.86,77,2011,2,12.998
177,109,68,0,18.86,72,2011,2,8.9981
114,73,41,1,18.86,72,2011,2,8.9981
35,19,16,2,18.04,77,2011,2,15.0013
16,7,9,3,18.04,77,2011,2,8.9981
17,8,9,4,18.04,77,2011,2,11.0014
20,16,4,5,18.04,77,2011,2,8.9981
62,59,3,6,18.04,88,2011,2,7.0015
209,193,16,7,18.86,82,2011,2,22.0028
371,350,21,8,19.68,77,2011,2,15.0013
172,131,41,9,20.5,77,2011,2,19.0012
108,77,31,10,22.14,77,2011,2,15.0013
130,96,34,11,23.78,73,2011,2,19.9995
187,147,40,12,25.42,69,2011,2,15.0013
170,119,51,13,25.42,69,2011,2,12.998
181,133,48,14,26.24,69,2011,2,15.0013
155,110,45,15,27.06,61,2011,2,12.998
269,220,49,16,27.06,61,2011,2,15.0013
537,472,65,17,27.06,65,2011,2,12.998
518,450,68,18,26.24,65,2011,2,12.998
314,268,46,19,25.42,69,2011,2,8.9981
218,174,44,20,25.42,69,2011,2,8.9981
232,178,54,21,24.6,73,2011,2,7.0015
125,97,28,22,24.6,73,2011,2,13.595043
64,48,16,23,22.96,83,2011,2,12.998
16,16,0,0,22.96,83,2011,2,15.0013
14,14,0,1,22.96,78,2011,2,16.9979
5,5,0,2,22.96,78,2011,2,16.9979
2,2,0,3,22.14,83,2011,2,19.0012
4,1,3,4,21.32,88,2011,2,15.0013
14,14,0,5,21.32,88,2011,2,8.9981
109,102,7,6,21.32,94,2011,2,11.0014
265,248,17,7,22.14,88,2011,2,15.0013
459,435,24,8,22.96,83,2011,2,19.0012
186,157,29,9,24.6,78,2011,2,23.9994
127,91,36,10,26.24,69,2011,2,23.9994
140,120,20,11,27.06,65,2011,2,22.0028
217,169,48,12,27.88,61,2011,2,32.9975
194,144,50,13,28.7,58,2011,2,40.9973
158,122,36,14,28.7,58,2011,2,35.0008
154,117,37,15,28.7,58,2011,2,30.0026
271,225,46,16,29.52,54,2011,2,31.0009
517,464,53,17,28.7,54,2011,2,31.0009
544,485,59,18,28.7,48,2011,2,27.9993
365,323,42,19,27.88,57,2011,2,23.9994
290,262,28,20,27.06,61,2011,2,12.998
225,183,42,21,26.24,61,2011,2,30.0026
113,99,14,22,23.78,60,2011,2,26.0027
62,50,12,23,22.96,68,2011,2,22.0028
27,22,5,0,21.32,77,2011,2,11.0014
7,6,1,1,20.5,82,2011,2,19.0012
4,4,0,2,20.5,82,2011,2,19.0012
1,1,0,3,17.22,88,2011,2,35.0008
3,2,1,4,15.58,94,2011,2,22.0028
9,8,1,5,14.76,87,2011,2,22.0028
21,21,0,6,13.94,93,2011,2,26.0027
52,46,6,7,13.94,93,2011,2,23.9994
79,74,5,8,13.94,93,2011,2,26.0027
40,35,5,9,13.94,93,2011,2,23.9994
31,26,5,10,13.94,93,2011,2,19.0012
72,69,3,11,16.4,82,2011,2,22.0028
124,105,19,12,18.04,62,2011,2,23.9994
143,128,15,13,18.86,59,2011,2,30.0026
107,94,13,14,20.5,51,2011,2,26.0027
129,107,22,15,19.68,51,2011,2,27.9993
195,173,22,16,20.5,45,2011,2,31.0009
410,388,22,17,16.4,71,2011,2,16.9979
396,367,29,18,17.22,67,2011,2,16.9979
296,266,30,19,17.22,58,2011,2,23.9994
191,174,17,20,16.4,62,2011,2,22.0028
150,133,17,21,16.4,62,2011,2,11.0014
89,80,9,22,15.58,62,2011,2,15.0013
57,49,8,23,14.76,62,2011,2,15.0013
27,23,4,0,14.76,66,2011,2,12.998
10,6,4,1,13.94,71,2011,2,12.998
5,4,1,2,13.94,66,2011,2,15.0013
4,4,0,3,13.94,66,2011,2,16.9979
7,3,4,4,13.94,66,2011,2,16.9979
30,29,1,5,13.94,66,2011,2,16.9979
89,86,3,6,13.94,66,2011,2,16.9979
271,255,16,7,15.58,58,2011,2,16.9979
440,415,25,8,17.22,50,2011,2,16.9979
184,164,20,9,18.86,44,2011,2,19.0012
128,98,30,10,20.5,39,2011,2,19.0012
148,105,43,11,21.32,36,2011,2,30.0026
196,169,27,12,21.32,34,2011,2,23.9994
192,142,50,13,22.14,30,2011,2,39.0007
154,135,19,14,22.14,28,2011,2,30.0026
147,120,27,15,22.96,26,2011,2,32.9975
269,233,36,16,23.78,24,2011,2,27.9993
533,467,66,17,22.96,26,2011,2,26.0027
520,456,64,18,22.96,26,2011,2,19.0012
361,305,56,19,22.14,28,2011,2,15.0013
258,225,33,20,20.5,34,2011,2,11.0014
180,141,39,21,20.5,36,2011,2,12.998
165,135,30,22,19.68,39,2011,2,12.998
115,99,16,23,18.86,41,2011,2,12.998
56,43,13,0,18.04,44,2011,2,11.0014
32,24,8,1,16.4,62,2011,2,11.0014
16,15,1,2,15.58,62,2011,2,7.0015
9,6,3,3,14.76,71,2011,2,7.0015
1,1,0,4,14.76,71,2011,2,7.0015
16,16,0,5,13.94,81,2011,2,7.0015
82,74,8,6,14.76,81,2011,2,6.0032
222,202,20,7,16.4,82,2011,2,9.984941458
450,415,35,8,17.22,77,2011,2,16.9979
188,161,27,9,18.86,67,2011,2,19.0012
127,97,30,10,22.14,49,2011,2,22.0028
165,123,42,11,22.14,49,2011,2,22.0028
246,198,48,12,22.96,49,2011,2,23.9994
253,182,71,13,23.78,40,2011,2,22.0028
213,127,86,14,24.6,40,2011,2,30.0026
260,171,89,15,24.6,38,2011,2,26.0027
344,262,82,16,24.6,40,2011,2,16.9979
553,470,83,17,23.78,40,2011,2,23.9994
470,385,85,18,22.14,52,2011,2,23.9994
292,253,39,19,22.14,52,2011,2,23.9994
190,161,29,20,21.32,48,2011,2,7.0015
152,130,22,21,19.68,67,2011,2,8.9981
151,105,46,22,18.86,72,2011,2,15.0013
120,93,27,23,18.04,82,2011,2,8.9981
86,76,10,0,17.22,82,2011,2,8.9981
58,50,8,1,17.22,82,2011,2,7.0015
52,47,5,2,17.22,82,2011,2,6.0032
18,9,9,3,17.22,77,2011,2,6.0032
5,4,1,4,16.4,82,2011,2,7.0015
7,3,4,5,18.86,59,2011,2,8.9981
13,12,1,6,17.22,77,2011,2,6.0032
40,32,8,7,19.68,59,2011,2,14.5044252
115,96,19,8,21.32,52,2011,2,12.998
218,164,54,9,22.14,49,2011,2,19.0012
298,208,90,10,22.96,49,2011,2,19.9995
347,215,132,11,22.96,43,2011,2,15.4990903
373,244,129,12,24.6,40,2011,2,12.998
436,240,196,13,24.6,35,2011,2,19.0012
378,235,143,14,24.6,35,2011,2,11.0014
378,230,148,15,24.6,38,2011,2,16.9979
342,223,119,16,24.6,38,2011,2,12.998
354,216,138,17,23.78,40,2011,2,15.0013
289,175,114,18,23.78,37,2011,2,11.0014
267,179,88,19,22.96,43,2011,2,12.998
219,137,82,20,22.96,43,2011,2,8.9981
182,124,58,21,22.14,49,2011,2,15.0013
120,94,26,22,22.14,49,2011,2,12.998
119,89,30,23,20.5,59,2011,2,7.0015
100,78,22,0,20.5,59,2011,2,7.0015
64,56,8,1,21.32,55,2011,2,15.01013485
59,42,17,2,19.68,63,2011,2,14.2232503
31,21,10,3,18.86,72,2011,2,6.0032
10,8,2,4,17.22,82,2011,2,10.10872318
5,5,0,5,18.04,77,2011,2,12.31841562
6,4,2,6,18.04,82,2011,2,12.2175997
23,15,8,7,18.86,82,2011,2,12.23693014
86,58,28,8,21.32,63,2011,2,8.9981
160,112,48,9,22.96,52,2011,2,15.0013
244,153,91,10,23.78,49,2011,2,8.9981
340,198,142,11,23.78,49,2011,2,6.0032
382,243,139,12,24.6,46,2011,2,6.0032
390,224,166,13,24.6,49,2011,2,8.9981
366,240,126,14,24.6,49,2011,2,15.39617579
358,230,128,15,24.6,49,2011,2,15.39617579
385,263,122,16,24.6,46,2011,2,7.0015
351,245,106,17,23.78,49,2011,2,19.0012
268,205,63,18,23.78,49,2011,2,15.50940524
239,178,61,19,22.96,64,2011,2,12.92676628
174,132,42,20,21.32,77,2011,2,8.9981
127,95,32,21,21.32,77,2011,2,6.0032
115,86,29,22,20.5,88,2011,2,6.0032
50,41,9,23,18.86,88,2011,2,6.0032
53,22,31,0,18.86,82,2011,2,6.0032
33,8,25,1,18.04,88,2011,2,9.979635594
8,2,6,2,18.04,94,2011,2,8.76667453
7,7,0,3,18.86,82,2011,2,6.0032
4,4,0,4,17.22,82,2011,2,11.0014
23,23,0,5,17.22,77,2011,2,11.0014
89,87,2,6,18.04,72,2011,2,16.9979
237,221,16,7,19.68,63,2011,2,16.9979
374,351,23,8,21.32,55,2011,2,15.0013
178,142,36,9,22.14,56,2011,2,11.0014
119,95,24,10,22.96,52,2011,2,12.998
125,99,26,11,24.6,46,2011,2,15.0013
195,160,35,12,24.6,43,2011,2,12.998
174,138,36,13,25.42,38,2011,2,19.0012
162,118,44,14,25.42,41,2011,2,15.0013
199,148,51,15,25.42,41,2011,2,15.0013
304,255,49,16,26.24,38,2011,2,15.0013
598,539,59,17,25.42,38,2011,2,16.9979
524,458,66,18,25.42,38,2011,2,19.9995
384,339,45,19,23.78,43,2011,2,12.998
239,214,25,20,22.14,49,2011,2,12.998
156,128,28,21,21.32,59,2011,2,8.9981
116,95,21,22,21.32,68,2011,2,6.0032
61,45,16,23,20.5,68,2011,2,6.0032
18,12,6,0,19.68,63,2011,2,14.2232503
15,12,3,1,18.86,59,2011,2,6.0032
5,4,1,2,18.04,58,2011,2,8.9981
4,3,1,3,18.04,54,2011,2,12.998
2,2,0,4,17.22,62,2011,2,16.9979
29,28,1,5,16.4,66,2011,2,15.0013
112,103,9,6,17.22,67,2011,2,8.9981
314,301,13,7,18.04,62,2011,2,8.9981
425,397,28,8,20.5,51,2011,2,7.0015
205,176,29,9,21.32,48,2011,2,7.0015
127,100,27,10,22.96,37,2011,2,6.0032
125,108,17,11,22.96,43,2011,2,8.9981
217,170,47,12,24.6,38,2011,2,16.0182977
202,152,50,13,25.42,38,2011,2,16.9979
176,134,42,14,25.42,33,2011,2,16.0155486
180,152,28,15,26.24,33,2011,2,6.0032
327,271,56,16,27.06,31,2011,2,7.0015
611,532,79,17,26.24,33,2011,2,15.80614719
550,480,70,18,26.24,29,2011,2,8.9981
434,365,69,19,24.6,43,2011,2,15.0013
291,241,50,20,22.14,60,2011,2,8.9981
203,173,30,21,22.14,52,2011,2,15.84944447
150,121,29,22,21.32,55,2011,2,7.0015
81,72,9,23,21.32,59,2011,2,8.9981
38,30,8,0,21.32,55,2011,2,8.9981
20,16,4,1,20.5,59,2011,2,7.0015
10,4,6,2,21.32,59,2011,2,14.40026374
3,3,0,3,20.5,63,2011,2,15.0013
2,2,0,4,19.68,88,2011,2,8.9981
20,20,0,5,18.86,88,2011,2,8.9981
99,93,6,6,18.86,82,2011,2,8.9981
318,293,25,7,19.68,72,2011,2,12.998
442,421,21,8,19.68,77,2011,2,16.9979
203,182,21,9,21.32,72,2011,2,8.9981
154,124,30,10,22.14,68,2011,2,6.0032
141,123,18,11,22.96,64,2011,2,6.0032
226,185,41,12,24.6,56,2011,2,14.73085172
193,157,36,13,25.42,50,2011,2,15.16771555
177,141,36,14,25.42,53,2011,2,6.0032
179,131,48,15,26.24,41,2011,2,15.69436079
289,240,49,16,27.06,39,2011,2,15.97979309
259,242,17,17,26.24,47,2011,2,7.0015
274,234,40,18,25.42,50,2011,2,19.9995
401,341,60,19,22.96,52,2011,2,8.9981
273,245,28,20,22.14,64,2011,2,8.9981
234,202,32,21,22.14,60,2011,2,14.16220774
146,134,12,22,20.5,72,2011,2,16.9979
81,69,12,23,18.86,88,2011,2,16.9979
44,39,5,0,18.86,88,2011,2,15.0013
17,16,1,1,18.86,88,2011,2,15.0013
15,14,1,2,18.04,94,2011,2,12.998
5,5,0,3,18.04,88,2011,2,8.9981
6,5,1,4,17.22,94,2011,2,8.728996104
29,27,2,5,17.22,94,2011,2,8.9981
112,103,9,6,18.04,88,2011,2,9.979635594
297,283,14,7,18.86,88,2011,2,8.9981
421,394,27,8,19.68,82,2011,2,12.998
212,191,21,9,20.5,77,2011,2,19.0012
147,119,28,10,22.14,68,2011,2,15.0013
179,136,43,11,23.78,60,2011,2,15.0013
207,164,43,12,23.78,60,2011,2,15.0013
218,170,48,13,25.42,57,2011,2,19.9995
191,148,43,14,25.42,61,2011,2,15.0013
217,163,54,15,26.24,53,2011,2,16.9979
288,238,50,16,26.24,57,2011,2,16.9979
594,540,54,17,26.24,57,2011,2,12.998
527,463,64,18,25.42,69,2011,2,15.0013
364,305,59,19,24.6,64,2011,2,12.998
276,220,56,20,24.6,64,2011,2,12.998
223,192,31,21,22.96,83,2011,2,8.9981
172,147,25,22,22.14,83,2011,2,12.998
103,87,16,23,22.14,77,2011,2,12.998
52,46,6,0,21.32,83,2011,2,11.0014
20,15,5,1,21.32,83,2011,2,11.0014
11,8,3,2,20.5,88,2011,2,8.9981
4,2,2,3,20.5,88,2011,2,8.9981
5,3,2,4,20.5,88,2011,2,11.0014
25,24,1,5,20.5,88,2011,2,12.998
82,76,6,6,20.5,88,2011,2,8.9981
157,141,16,7,20.5,88,2011,2,11.0014
387,361,26,8,20.5,88,2011,2,12.998
233,215,18,9,20.5,88,2011,2,12.998
130,99,31,10,21.32,83,2011,2,8.9981
146,90,56,11,21.32,83,2011,2,11.0014
223,170,53,12,21.32,88,2011,2,12.998
226,157,69,13,21.32,88,2011,2,26.0027
190,120,70,14,21.32,87,2011,2,19.0012
198,142,56,15,21.32,88,2011,2,11.0014
300,256,44,16,21.32,88,2011,2,8.9981
491,429,62,17,21.32,88,2011,2,11.0014
398,359,39,18,21.32,88,2011,2,11.0014
270,245,25,19,21.32,83,2011,2,12.998
152,130,22,20,21.32,83,2011,2,8.9981
154,130,24,21,21.32,84,2011,2,11.0014
132,107,25,22,21.32,83,2011,2,15.0013
119,88,31,23,20.5,88,2011,2,11.0014
102,78,24,0,20.5,88,2011,2,8.9981
82,64,18,1,20.5,88,2011,2,8.9981
52,37,15,2,20.5,88,2011,2,8.9981
35,30,5,3,20.5,88,2011,2,8.9981
5,4,1,4,20.5,82,2011,2,11.0014
14,7,7,5,20.5,82,2011,2,7.0015
11,9,2,6,20.5,88,2011,2,7.0015
32,28,4,7,19.68,100,2011,2,12.58488641
88,72,16,8,20.5,94,2011,2,16.65050966
100,86,14,9,21.32,94,2011,2,6.0032
167,133,34,10,21.32,94,2011,2,11.0014
279,207,72,11,21.32,94,2011,2,8.9981
279,204,75,12,21.32,100,2011,2,6.0032
248,180,68,13,21.32,100,2011,2,6.0032
216,159,57,14,22.14,94,2011,2,8.9981
294,221,73,15,22.14,94,2011,2,11.0014
295,188,107,16,22.14,94,2011,2,12.998
272,194,78,17,22.96,88,2011,2,12.998
304,216,88,18,22.96,88,2011,2,15.0013
248,179,69,19,22.14,94,2011,2,8.9981
157,115,42,20,22.14,94,2011,2,8.9981
59,44,15,21,22.14,94,2011,2,15.0013
26,19,7,22,22.14,94,2011,2,11.0014
44,33,11,23,21.32,100,2011,2,12.998
39,34,5,0,21.32,100,2011,2,11.06633096
47,43,4,1,21.32,100,2011,2,7.0015
50,37,13,2,21.32,100,2011,2,8.9981
32,21,11,3,21.32,100,2011,2,11.06633096
13,8,5,4,21.32,100,2011,2,11.06633096
14,11,3,5,21.32,100,2011,2,7.0015
17,14,3,6,21.32,100,2011,2,8.9981
42,38,4,7,21.32,100,2011,2,8.9981
70,46,24,8,22.14,94,2011,2,8.9981
134,98,36,9,23.78,83,2011,2,16.9979
226,153,73,10,23.78,83,2011,2,15.0013
322,202,120,11,24.6,78,2011,2,15.0013
367,247,120,12,25.42,73,2011,2,19.9995
456,261,195,13,25.42,73,2011,2,19.0012
437,254,183,14,26.24,73,2011,2,12.998
459,253,206,15,27.06,69,2011,2,16.9979
440,282,158,16,26.24,69,2011,2,16.9979
392,255,137,17,22.96,78,2011,2,23.9994
237,177,60,18,22.96,78,2011,2,16.9979
231,153,78,19,22.96,83,2011,2,7.0015
191,138,53,20,22.14,88,2011,2,10.58906308
151,107,44,21,22.14,88,2011,2,10.58906308
117,88,29,22,22.96,83,2011,2,11.33749486
69,51,18,23,22.14,88,2011,2,15.0013
38,21,17,0,21.32,94,2011,2,7.0015
14,8,6,1,21.32,94,2011,2,8.9981
13,9,4,2,20.5,100,2011,2,6.0032
4,3,1,3,20.5,94,2011,2,11.0014
6,5,1,4,20.5,100,2011,2,8.9981
21,20,1,5,20.5,93,2011,2,12.998
104,93,11,6,21.32,88,2011,2,11.0014
272,245,27,7,21.32,83,2011,2,19.0012
394,366,28,8,22.96,73,2011,2,19.9995
194,156,38,9,24.6,69,2011,2,12.998
112,75,37,10,25.42,65,2011,2,6.0032
185,129,56,11,26.24,57,2011,2,14.95181071
209,137,72,12,27.06,54,2011,2,6.0032
214,153,61,13,27.88,51,2011,2,14.39394606
193,117,76,14,27.88,51,2011,2,14.39394606
165,110,55,15,29.52,51,2011,2,14.44650389
226,181,45,16,24.6,78,2011,2,16.9979
274,227,47,17,23.78,88,2011,2,15.0013
453,398,55,18,23.78,83,2011,2,12.998
308,272,36,19,23.78,83,2011,2,16.9979
198,167,31,20,23.78,83,2011,2,11.31781251
177,149,28,21,23.78,83,2011,2,11.31781251
127,105,22,22,22.96,88,2011,2,6.0032
57,39,18,23,22.96,88,2011,2,6.0032
31,18,13,0,22.96,88,2011,2,12.73039414
13,6,7,1,22.96,88,2011,2,15.56173915
8,4,4,2,22.96,88,2011,2,15.56173915
4,3,1,3,22.14,94,2011,2,16.9979
4,2,2,4,22.14,94,2011,2,16.9979
22,22,0,5,21.32,94,2011,2,16.9979
49,49,0,6,21.32,94,2011,2,16.9979
151,138,13,7,21.32,94,2011,2,16.9979
347,325,22,8,21.32,94,2011,2,19.9995
207,190,17,9,22.14,88,2011,2,16.9979
104,73,31,10,22.14,88,2011,2,16.9979
130,104,26,11,22.96,83,2011,2,27.9993
153,115,38,12,22.96,83,2011,2,27.9993
172,141,31,13,22.96,88,2011,2,22.0028
184,123,61,14,25.42,73,2011,2,31.0009
210,131,79,15,25.42,69,2011,2,30.0026
290,217,73,16,25.42,61,2011,2,22.0028
604,521,83,17,25.42,65,2011,2,27.9993
480,426,54,18,24.6,69,2011,2,19.9995
349,298,51,19,24.6,69,2011,2,16.9979
283,253,30,20,23.78,83,2011,2,27.9993
174,151,23,21,22.14,88,2011,2,16.9979
98,86,12,22,22.14,88,2011,2,19.0012
56,49,7,23,22.14,88,2011,2,16.9979
23,15,8,0,22.14,88,2011,2,15.0013
12,9,3,1,22.14,88,2011,2,16.9979
6,5,1,2,21.32,94,2011,2,15.0013
9,3,6,3,21.32,94,2011,2,19.9995
3,2,1,4,21.32,94,2011,2,19.9995
9,9,0,5,21.32,100,2011,2,15.0013
101,99,2,6,21.32,100,2011,2,8.9981
274,260,14,7,22.14,88,2011,2,12.998
453,428,25,8,22.96,88,2011,2,19.0012
202,176,26,9,22.96,83,2011,2,16.9979
106,73,33,10,22.14,88,2011,2,19.0012
23,17,6,11,22.14,94,2011,2,6.0032
54,42,12,12,22.96,94,2011,2,19.9995
122,92,30,13,22.96,83,2011,2,22.0028
138,94,44,14,23.78,78,2011,2,19.0012
167,133,34,15,24.6,78,2011,2,16.9979
294,241,53,16,24.6,73,2011,2,12.998
565,487,78,17,24.6,69,2011,2,8.9981
489,431,58,18,24.6,73,2011,2,15.0013
331,288,43,19,22.96,88,2011,2,8.9981
213,189,24,20,22.96,88,2011,2,8.9981
85,74,11,21,21.32,88,2011,2,10.32226348
117,103,14,22,21.32,83,2011,2,10.90587995
59,49,10,23,21.32,94,2011,2,6.0032
29,23,6,0,21.32,94,2011,2,7.0015
6,4,2,1,20.5,94,2011,2,9.041520472
15,12,3,2,20.5,94,2011,2,9.041520472
4,3,1,3,19.68,100,2011,2,8.994505431
5,3,2,4,19.68,94,2011,2,8.99544749
26,24,2,5,19.68,94,2011,2,8.99544749
103,86,17,6,20.5,94,2011,2,11.20074344
257,239,18,7,20.5,100,2011,2,11.09906221
487,453,34,8,21.32,88,2011,2,12.04608035
216,176,40,9,22.14,88,2011,2,6.0032
130,95,35,10,22.14,83,2011,2,13.40740539
164,111,53,11,22.14,88,2011,2,11.0014
168,130,38,12,23.78,78,2011,2,7.0015
183,139,44,13,23.78,64,2011,2,16.9979
180,137,43,14,22.14,73,2011,2,12.998
188,125,63,15,22.96,78,2011,2,11.0014
302,247,55,16,23.78,64,2011,2,12.998
547,487,60,17,22.96,78,2011,2,11.0014
513,454,59,18,24.6,55,2011,2,11.0014
410,345,65,19,23.78,60,2011,2,8.9981
282,236,46,20,22.14,77,2011,2,19.0012
209,180,29,21,22.14,77,2011,2,19.0012
79,68,11,22,20.5,82,2011,2,19.9995
72,63,9,23,19.68,94,2011,2,8.99544749
34,25,9,0,28.7,79,2011,2,11.0014
17,9,8,1,28.7,84,2011,2,16.9979
3,3,0,2,28.7,79,2011,2,11.0014
6,6,0,3,27.88,89,2011,2,12.998
4,4,0,4,27.88,89,2011,2,15.0013
21,19,2,5,27.06,89,2011,2,6.0032
128,121,7,6,27.88,89,2011,2,6.0032
284,265,19,7,28.7,79,2011,2,11.0014
454,417,37,8,29.52,79,2011,2,12.998
207,173,34,9,30.34,74,2011,2,15.0013
115,84,31,10,31.16,75,2011,2,16.9979
112,86,26,11,33.62,59,2011,2,15.0013
169,137,32,12,35.26,53,2011,2,15.29697688
154,125,29,13,36.9,37,2011,2,12.998
145,105,40,14,36.9,37,2011,2,16.9979
152,127,25,15,36.9,39,2011,2,19.9995
266,227,39,16,35.26,47,2011,2,19.9995
486,434,52,17,35.26,47,2011,2,19.9995
309,278,31,18,33.62,56,2011,2,26.0027
264,248,16,19,30.34,79,2011,2,11.0014
256,233,23,20,30.34,79,2011,2,16.9979
190,161,29,21,30.34,70,2011,2,19.0012
129,115,14,22,30.34,66,2011,2,8.9981
69,59,10,23,30.34,51,2011,2,11.0014
42,31,11,0,30.34,40,2011,2,23.9994
15,12,3,1,29.52,38,2011,2,7.0015
6,6,0,2,28.7,39,2011,2,15.92398523
4,4,0,3,27.06,44,2011,2,7.0015
3,3,0,4,27.06,41,2011,2,12.998
31,28,3,5,27.06,39,2011,2,15.0013
113,106,7,6,27.06,39,2011,2,8.9981
304,285,19,7,28.7,34,2011,2,16.9979
467,442,25,8,28.7,32,2011,2,19.9995
225,197,28,9,29.52,26,2011,2,23.9994
139,106,33,10,29.52,28,2011,2,32.9975
165,123,42,11,30.34,28,2011,2,26.0027
232,193,39,12,31.16,25,2011,2,31.0009
203,168,35,13,32.8,24,2011,2,23.9994
185,142,43,14,31.98,24,2011,2,22.0028
188,144,44,15,32.8,21,2011,2,26.0027
318,255,63,16,32.8,22,2011,2,32.9975
572,484,88,17,31.16,20,2011,2,35.0008
525,451,74,18,30.34,22,2011,2,26.0027
379,321,58,19,29.52,23,2011,2,19.9995
337,286,51,20,28.7,24,2011,2,12.998
248,215,33,21,27.06,31,2011,2,12.998
155,141,14,22,26.24,33,2011,2,16.9979
112,89,23,23,25.42,35,2011,2,15.0013
68,53,15,0,25.42,38,2011,2,19.0012
22,15,7,1,24.6,38,2011,2,23.9994
12,12,0,2,22.96,43,2011,2,15.0013
5,5,0,3,22.14,49,2011,2,15.0013
6,5,1,4,21.32,48,2011,2,22.0028
28,24,4,5,21.32,48,2011,2,23.9994
106,98,8,6,22.14,45,2011,2,19.9995
277,252,25,7,22.14,45,2011,2,16.9979
502,471,31,8,22.96,43,2011,2,22.0028
230,194,36,9,23.78,40,2011,2,11.0014
161,107,54,10,25.42,33,2011,2,16.9979
192,135,57,11,26.24,31,2011,2,22.0028
259,208,51,12,27.06,27,2011,2,19.0012
248,190,58,13,27.88,26,2011,2,16.9979
240,174,66,14,28.7,28,2011,2,19.0012
212,156,56,15,28.7,28,2011,2,19.0012
349,286,63,16,29.52,26,2011,2,22.0028
558,485,73,17,29.52,25,2011,2,19.0012
564,488,76,18,28.7,24,2011,2,19.9995
391,338,53,19,27.88,26,2011,2,19.0012
293,236,57,20,26.24,29,2011,2,11.0014
247,196,51,21,26.24,29,2011,2,7.0015
171,145,26,22,25.42,35,2011,2,16.87366204
171,141,30,23,23.78,46,2011,2,7.0015
93,69,24,0,22.96,52,2011,2,15.63110477
94,80,14,1,22.14,64,2011,2,7.0015
59,41,18,2,22.14,56,2011,2,12.998
18,10,8,3,21.32,59,2011,2,7.0015
15,11,4,4,21.32,59,2011,2,6.0032
8,5,3,5,20.5,64,2011,2,13.56094042
28,17,11,6,22.14,60,2011,2,13.320692
87,60,27,7,22.96,56,2011,2,13.9686829
125,96,29,8,24.6,46,2011,2,6.0032
224,169,55,9,25.42,43,2011,2,8.9981
317,202,115,10,26.24,38,2011,2,7.0015
369,249,120,11,27.06,36,2011,2,8.9981
420,270,150,12,28.7,32,2011,2,11.0014
456,268,188,13,30.34,28,2011,2,8.9981
451,258,193,14,30.34,33,2011,2,15.0013
404,224,180,15,30.34,27,2011,2,27.9993
440,272,168,16,29.52,30,2011,2,8.9981
344,202,142,17,29.52,34,2011,2,16.9979
341,214,127,18,30.34,30,2011,2,11.0014
285,206,79,19,28.7,39,2011,2,6.0032
239,149,90,20,28.7,48,2011,2,6.0032
185,139,46,21,27.06,47,2011,2,7.0015
190,141,49,22,26.24,57,2011,2,15.0013
150,121,29,23,26.24,57,2011,2,13.38192371
113,90,23,0,26.24,57,2011,2,6.0032
96,70,26,1,26.24,61,2011,2,11.0014
64,48,16,2,26.24,61,2011,2,11.0014
47,25,22,3,25.42,65,2011,2,11.0014
12,8,4,4,25.42,65,2011,2,11.0014
6,5,1,5,25.42,61,2011,2,8.9981
21,11,10,6,25.42,61,2011,2,7.0015
27,19,8,7,24.6,73,2011,2,16.9979
98,74,24,8,24.6,73,2011,2,16.9979
164,111,53,9,24.6,78,2011,2,12.998
251,168,83,10,25.42,73,2011,2,6.0032
335,214,121,11,26.24,69,2011,2,7.0015
335,212,123,12,26.24,69,2011,2,7.0015
367,213,154,13,27.06,65,2011,2,7.0015
385,224,161,14,28.7,58,2011,2,11.0014
417,256,161,15,28.7,54,2011,2,13.81076365
398,260,138,16,29.52,51,2011,2,6.0032
390,264,126,17,30.34,51,2011,2,14.09696033
363,239,124,18,28.7,58,2011,2,7.0015
357,249,108,19,27.88,65,2011,2,11.0014
279,195,84,20,27.06,69,2011,2,12.998
165,111,54,21,26.24,73,2011,2,11.0014
130,94,36,22,26.24,78,2011,2,15.0013
86,61,25,23,25.42,78,2011,2,8.9981
29,18,11,0,25.42,78,2011,2,8.9981
14,5,9,1,24.6,83,2011,2,8.9981
8,4,4,2,23.78,88,2011,2,7.0015
5,3,2,3,23.78,88,2011,2,10.05980357
8,4,4,4,22.96,94,2011,2,7.0015
31,24,7,5,22.96,88,2011,2,6.0032
112,101,11,6,23.78,88,2011,2,10.05980357
299,281,18,7,25.42,78,2011,2,7.0015
438,410,28,8,26.24,73,2011,2,6.0032
188,162,26,9,28.7,58,2011,2,11.0014
95,64,31,10,29.52,51,2011,2,15.0013
111,72,39,11,30.34,42,2011,2,8.9981
153,128,25,12,31.16,37,2011,2,11.0014
180,152,28,13,31.98,35,2011,2,15.41694671
145,99,46,14,31.98,31,2011,2,8.9981
165,127,38,15,32.8,29,2011,2,12.998
267,233,34,16,31.16,33,2011,2,8.9981
579,516,63,17,31.98,33,2011,2,19.0012
556,500,56,18,31.16,31,2011,2,8.9981
407,343,64,19,29.52,54,2011,2,12.998
336,277,59,20,27.88,61,2011,2,8.9981
189,160,29,21,27.06,57,2011,2,6.0032
173,137,36,22,27.06,61,2011,2,6.0032
60,55,5,23,26.24,69,2011,2,6.0032
20,15,5,0,26.24,65,2011,2,6.0032
4,2,2,1,25.42,69,2011,2,8.9981
5,2,3,2,24.6,73,2011,2,6.0032
2,1,1,3,24.6,73,2011,2,6.0032
5,3,2,4,23.78,83,2011,2,8.9981
32,30,2,5,23.78,88,2011,2,11.0014
126,116,10,6,24.6,78,2011,2,8.9981
334,311,23,7,26.24,69,2011,2,12.998
477,432,45,8,27.88,61,2011,2,8.9981
217,190,27,9,29.52,58,2011,2,15.0013
123,86,37,10,31.16,48,2011,2,12.998
151,113,38,11,31.16,52,2011,2,16.9979
183,141,42,12,32.8,46,2011,2,19.0012
196,141,55,13,32.8,43,2011,2,16.9979
146,112,34,14,32.8,43,2011,2,19.0012
183,127,56,15,33.62,41,2011,2,22.0028
308,253,55,16,32.8,38,2011,2,15.0013
539,475,64,17,32.8,43,2011,2,16.9979
551,479,72,18,31.98,46,2011,2,19.0012
424,355,69,19,31.16,48,2011,2,16.9979
346,301,45,20,30.34,56,2011,2,8.9981
218,187,31,21,29.52,70,2011,2,8.9981
153,126,27,22,28.7,65,2011,2,8.9981
90,72,18,23,27.88,79,2011,2,7.0015
41,29,12,0,27.06,89,2011,2,8.9981
23,20,3,1,27.06,78,2011,2,10.81852936
7,7,0,2,26.24,89,2011,2,6.0032
3,1,2,3,26.24,89,2011,2,6.0032
6,6,0,4,25.42,83,2011,2,10.51416952
21,21,0,5,25.42,88,2011,2,10.06708721
116,103,13,6,26.24,89,2011,2,8.9981
353,329,24,7,27.06,74,2011,2,7.0015
481,435,46,8,31.16,58,2011,2,11.0014
202,168,34,9,31.16,58,2011,2,11.0014
90,63,27,10,33.62,43,2011,2,15.0013
134,106,28,11,34.44,41,2011,2,12.998
149,134,15,12,36.08,42,2011,2,8.9981
136,116,20,13,36.9,42,2011,2,15.50158358
155,111,44,14,37.72,40,2011,2,16.9979
128,100,28,15,37.72,40,2011,2,11.0014
233,199,34,16,37.72,40,2011,2,15.0013
506,426,80,17,37.72,35,2011,2,15.0013
459,398,61,18,36.9,37,2011,2,15.0013
384,323,61,19,33.62,59,2011,2,8.9981
280,225,55,20,32.8,63,2011,2,8.9981
202,168,34,21,32.8,66,2011,2,8.9981
176,139,37,22,31.16,75,2011,2,11.0014
116,98,18,23,31.16,75,2011,2,12.998
47,40,7,0,30.34,79,2011,2,8.9981
16,13,3,1,30.34,79,2011,2,7.0015
6,6,0,2,29.52,84,2011,2,11.0014
2,2,0,3,29.52,84,2011,2,7.0015
6,4,2,4,29.52,79,2011,2,6.0032
20,19,1,5,28.7,84,2011,2,11.37297603
118,105,13,6,29.52,84,2011,2,6.0032
314,283,31,7,29.52,79,2011,2,8.9981
432,400,32,8,31.16,70,2011,2,7.0015
168,148,20,9,34.44,49,2011,2,14.97900028
94,74,20,10,35.26,50,2011,2,19.0012
118,82,36,11,36.9,42,2011,2,15.0013
140,100,40,12,37.72,35,2011,2,12.998
136,118,18,13,36.9,37,2011,2,6.0032
118,93,25,14,37.72,40,2011,2,12.998
104,86,18,15,38.54,31,2011,2,11.0014
200,170,30,16,37.72,33,2011,2,8.9981
409,355,54,17,36.9,37,2011,2,16.9979
466,414,52,18,36.08,39,2011,2,19.0012
326,271,55,19,34.44,39,2011,2,22.0028
254,214,40,20,32.8,43,2011,2,12.998
171,142,29,21,31.16,52,2011,2,20.14855446
153,131,22,22,30.34,58,2011,2,11.0014
97,82,15,23,30.34,57,2011,2,11.0014
69,61,8,0,28.7,65,2011,2,15.0013
23,18,5,1,28.7,65,2011,2,15.0013
13,7,6,2,27.88,69,2011,2,11.0014
6,3,3,3,27.88,69,2011,2,11.0014
4,4,0,4,27.06,78,2011,2,11.0014
28,28,0,5,27.06,78,2011,2,11.0014
104,94,10,6,27.06,78,2011,2,6.0032
267,242,25,7,29.52,66,2011,2,7.0015
452,423,29,8,30.34,58,2011,2,8.9981
213,176,37,9,31.16,55,2011,2,14.02879492
111,88,23,10,31.98,52,2011,2,15.05310719
153,107,46,11,33.62,46,2011,2,15.01879188
207,167,40,12,34.44,44,2011,2,8.9981
189,149,40,13,34.44,44,2011,2,7.0015
165,121,44,14,35.26,39,2011,2,15.29212594
212,163,49,15,34.44,44,2011,2,7.0015
285,239,46,16,33.62,56,2011,2,19.9995
517,454,63,17,33.62,52,2011,2,15.0013
463,367,96,18,32.8,59,2011,2,15.0013
306,245,61,19,31.98,59,2011,2,12.998
250,197,53,20,31.16,62,2011,2,7.0015
218,163,55,21,31.16,66,2011,2,8.9981
185,145,40,22,29.52,74,2011,2,16.9979
146,110,36,23,29.52,74,2011,2,11.0014
117,89,28,0,28.7,79,2011,2,8.9981
77,67,10,1,28.7,79,2011,2,6.0032
60,50,10,2,28.7,79,2011,2,7.0015
28,18,10,3,27.88,83,2011,2,6.0032
13,9,4,4,27.88,79,2011,2,6.0032
16,12,4,5,27.88,74,2011,2,8.9981
40,31,9,6,28.7,61,2011,2,8.9981
68,50,18,7,29.52,58,2011,2,12.998
143,111,32,8,30.34,58,2011,2,12.998
230,171,59,9,30.34,62,2011,2,8.9981
264,173,91,10,30.34,58,2011,2,11.0014
325,215,110,11,31.16,62,2011,2,8.9981
347,235,112,12,32.8,55,2011,2,15.0013
387,237,150,13,32.8,55,2011,2,12.998
380,232,148,14,33.62,49,2011,2,7.0015
374,232,142,15,33.62,49,2011,2,7.0015
394,225,169,16,32.8,46,2011,2,12.998
337,190,147,17,30.34,58,2011,2,11.0014
286,155,131,18,29.52,62,2011,2,8.9981
264,167,97,19,28.7,65,2011,2,12.998
275,180,95,20,27.88,74,2011,2,16.9979
220,144,76,21,27.06,74,2011,2,15.0013
190,137,53,22,27.06,78,2011,2,15.0013
131,107,24,23,27.06,74,2011,2,7.0015
119,100,19,0,27.06,78,2011,2,15.0013
93,74,19,1,26.24,83,2011,2,7.0015
66,57,9,2,26.24,89,2011,2,16.9979
28,20,8,3,26.24,89,2011,2,19.0012
14,6,8,4,25.42,88,2011,2,11.0014
10,5,5,5,25.42,88,2011,2,15.0013
14,9,5,6,25.42,88,2011,2,7.0015
34,27,7,7,26.24,78,2011,2,7.0015
92,64,28,8,28.7,74,2011,2,12.22623585
182,107,75,9,29.52,66,2011,2,12.37024975
311,191,120,10,31.16,58,2011,2,6.0032
367,236,131,11,31.98,55,2011,2,7.0015
420,244,176,12,33.62,46,2011,2,15.01879188
373,264,109,13,31.98,59,2011,2,19.0012
315,219,96,14,33.62,56,2011,2,16.9979
360,218,142,15,32.8,59,2011,2,19.9995
350,235,115,16,27.88,83,2011,2,19.0012
252,158,94,17,27.88,83,2011,2,19.0012
256,187,69,18,28.7,74,2011,2,11.0014
223,156,67,19,28.7,74,2011,2,7.0015
206,144,62,20,27.06,83,2011,2,11.0014
140,101,39,21,27.06,83,2011,2,7.0015
128,97,31,22,26.24,83,2011,2,8.9981
107,74,33,23,26.24,78,2011,2,12.998
28,20,8,0,26.24,78,2011,2,8.9981
16,10,6,1,26.24,73,2011,2,15.0013
10,8,2,2,25.42,73,2011,2,19.0012
7,6,1,3,24.6,60,2011,2,32.9975
4,3,1,4,22.96,64,2011,2,19.9995
29,27,2,5,22.14,64,2011,2,26.0027
105,98,7,6,22.14,64,2011,2,27.9993
328,302,26,7,22.96,56,2011,2,23.9994
476,432,44,8,23.78,49,2011,2,30.0026
224,189,35,9,25.42,46,2011,2,23.9994
118,80,38,10,26.24,41,2011,2,22.0028
159,106,53,11,27.06,41,2011,2,19.9995
196,161,35,12,27.06,41,2011,2,19.0012
227,174,53,13,28.7,37,2011,2,16.18042305
200,145,55,14,28.7,34,2011,2,16.9979
185,127,58,15,28.7,37,2011,2,30.0026
326,262,64,16,28.7,37,2011,2,27.9993
601,529,72,17,28.7,39,2011,2,22.0028
586,510,76,18,28.7,37,2011,2,23.9994
423,348,75,19,27.06,39,2011,2,19.0012
331,253,78,20,26.24,44,2011,2,16.9979
218,178,40,21,26.24,41,2011,2,16.9979
134,114,20,22,25.42,46,2011,2,15.0013
89,75,14,23,25.42,46,2011,2,12.998
31,18,13,0,24.6,49,2011,2,12.998
13,10,3,1,24.6,49,2011,2,16.9979
10,8,2,2,24.6,49,2011,2,19.0012
2,1,1,3,23.78,53,2011,2,22.0028
3,3,0,4,22.14,60,2011,2,16.9979
26,23,3,5,22.14,56,2011,2,22.0028
113,107,6,6,22.14,56,2011,2,19.9995
365,346,19,7,22.96,52,2011,2,27.9993
486,441,45,8,23.78,49,2011,2,26.0027
193,174,19,9,25.42,46,2011,2,12.998
130,97,33,10,25.42,46,2011,2,15.0013
143,103,40,11,26.24,41,2011,2,19.0012
169,139,30,12,26.24,41,2011,2,23.9994
209,176,33,13,26.24,44,2011,2,15.0013
159,118,41,14,26.24,47,2011,2,12.998
178,136,42,15,26.24,47,2011,2,11.0014
330,279,51,16,27.88,41,2011,2,12.998
569,484,85,17,26.24,50,2011,2,19.0012
538,473,65,18,25.42,51,2011,2,22.0028
386,335,51,19,26.24,50,2011,2,23.9994
297,237,60,20,24.6,56,2011,2,11.0014
243,206,37,21,24.6,56,2011,2,19.9995
188,159,29,22,23.78,60,2011,2,15.0013
110,91,19,23,22.96,68,2011,2,15.0013
52,44,8,0,22.96,64,2011,2,23.9994
14,14,0,1,22.14,64,2011,2,19.0012
9,9,0,2,21.32,63,2011,2,15.0013
1,1,0,3,20.5,68,2011,2,16.9979
4,4,0,4,20.5,63,2011,2,19.0012
21,20,1,5,19.68,67,2011,2,19.0012
121,110,11,6,20.5,63,2011,2,16.9979
370,348,22,7,22.14,60,2011,2,8.9981
498,445,53,8,23.78,53,2011,2,8.9981
207,185,22,9,24.6,49,2011,2,15.55302715
135,108,27,10,26.24,47,2011,2,11.0014
164,115,49,11,27.88,36,2011,2,16.31973561
211,178,33,12,28.7,34,2011,2,15.0013
189,146,43,13,30.34,28,2011,2,19.0012
178,128,50,14,30.34,28,2011,2,19.53271609
164,131,33,15,31.16,27,2011,2,20.64300689
312,265,47,16,31.16,27,2011,2,8.9981
638,555,83,17,30.34,28,2011,2,7.0015
607,527,80,18,29.52,32,2011,2,8.9981
416,362,54,19,28.7,37,2011,2,19.0012
330,273,57,20,27.06,44,2011,2,11.0014
257,209,48,21,26.24,47,2011,2,15.0013
175,144,31,22,25.42,50,2011,2,7.0015
107,90,17,23,25.42,53,2011,2,14.6743597
47,38,9,0,24.6,56,2011,2,7.0015
17,13,4,1,23.78,60,2011,2,13.31408836
5,4,1,2,24.6,56,2011,2,6.0032
4,4,0,3,22.96,73,2011,2,6.0032
6,6,0,4,22.96,68,2011,2,7.0015
25,18,7,5,24.6,64,2011,2,12.998
112,104,8,6,23.78,73,2011,2,11.0014
188,172,16,7,22.96,78,2011,2,11.0014
388,364,24,8,24.6,69,2011,2,8.9981
261,232,29,9,25.42,65,2011,2,12.998
121,103,18,10,27.06,61,2011,2,16.9979
150,117,33,11,27.88,61,2011,2,19.9995
206,165,41,12,29.52,54,2011,2,26.0027
151,114,37,13,29.52,54,2011,2,16.9979
153,114,39,14,29.52,54,2011,2,22.0028
159,127,32,15,28.7,61,2011,2,19.9995
294,258,36,16,27.06,69,2011,2,12.998
272,230,42,17,26.24,78,2011,2,7.0015
325,299,26,18,26.24,83,2011,2,15.0013
327,269,58,19,25.42,83,2011,2,19.0012
201,176,25,20,25.42,83,2011,2,22.0028
188,154,34,21,25.42,83,2011,2,16.9979
151,127,24,22,25.42,83,2011,2,16.9979
16,14,2,23,24.6,83,2011,2,16.9979
24,21,3,0,22.96,88,2011,2,6.0032
23,19,4,1,22.96,94,2011,2,8.9981
13,11,2,2,22.96,94,2011,2,7.0015
6,5,1,3,22.96,94,2011,2,7.0015
6,5,1,4,22.14,94,2011,2,8.9981
13,12,1,5,22.14,100,2011,2,9.00191829
97,89,8,6,22.96,94,2011,2,9.196133248
250,225,25,7,24.6,83,2011,2,10.49569984
454,426,28,8,24.6,83,2011,2,11.67068374
224,196,28,9,28.7,58,2011,2,12.998
170,126,44,10,28.7,58,2011,2,12.998
181,138,43,11,27.88,69,2011,2,16.9979
243,194,49,12,28.7,65,2011,2,16.9979
204,156,48,13,30.34,62,2011,2,19.0012
215,142,73,14,31.16,52,2011,2,12.998
243,181,62,15,31.98,43,2011,2,15.0013
355,286,69,16,31.16,45,2011,2,11.0014
552,467,85,17,31.16,40,2011,2,12.998
450,388,62,18,31.16,40,2011,2,12.998
328,275,53,19,26.24,83,2011,2,16.9979
232,192,40,20,26.24,78,2011,2,7.0015
208,159,49,21,26.24,78,2011,2,6.0032
175,127,48,22,25.42,88,2011,2,8.9981
178,141,37,23,25.42,83,2011,2,8.9981
104,83,21,0,25.42,88,2011,2,8.9981
95,80,15,1,25.42,83,2011,2,7.0015
53,37,16,2,24.6,88,2011,2,10.00563131
20,16,4,3,24.6,88,2011,2,6.0032
5,4,1,4,24.6,88,2011,2,6.0032
7,6,1,5,25.42,83,2011,2,10.51416952
27,18,9,6,25.42,83,2011,2,7.0015
57,45,12,7,26.24,78,2011,2,8.9981
131,103,28,8,27.06,78,2011,2,6.0032
218,156,62,9,28.7,61,2011,2,15.0013
244,176,68,10,29.52,62,2011,2,12.998
404,270,134,11,29.52,62,2011,2,8.9981
420,258,162,12,30.34,66,2011,2,6.0032
327,192,135,13,31.16,55,2011,2,14.02879492
334,196,138,14,32.8,46,2011,2,19.0012
367,214,153,15,33.62,46,2011,2,8.9981
468,275,193,16,31.16,52,2011,2,15.0013
449,239,210,17,31.16,48,2011,2,11.0014
381,263,118,18,30.34,55,2011,2,12.998
326,227,99,19,30.34,51,2011,2,7.0015
188,127,61,20,29.52,58,2011,2,8.9981
183,125,58,21,29.52,66,2011,2,7.0015
161,105,56,22,29.52,62,2011,2,8.9981
150,97,53,23,29.52,62,2011,2,12.9936318
89,71,18,0,28.7,65,2011,2,12.35812162
76,59,17,1,28.7,65,2011,2,6.0032
72,59,13,2,27.88,74,2011,2,6.0032
30,16,14,3,27.06,78,2011,2,8.9981
17,10,7,4,27.06,74,2011,2,8.9981
19,12,7,5,27.06,78,2011,2,11.73567433
33,22,11,6,27.06,78,2011,2,11.0014
71,36,35,7,27.06,78,2011,2,11.0014
84,59,25,8,27.88,74,2011,2,7.0015
169,111,58,9,27.88,74,2011,2,7.0015
244,158,86,10,28.7,61,2011,2,7.0015
377,236,141,11,29.52,58,2011,2,6.0032
396,255,141,12,30.34,55,2011,2,6.0032
363,214,149,13,30.34,51,2011,2,14.03511892
317,193,124,14,30.34,58,2011,2,7.0015
362,216,146,15,30.34,55,2011,2,7.0015
378,257,121,16,31.16,48,2011,2,14.58544651
397,238,159,17,30.34,51,2011,2,14.09696033
296,218,78,18,30.34,58,2011,2,6.0032
311,217,94,19,29.52,62,2011,2,8.9981
232,146,86,20,28.7,70,2011,2,12.998
167,110,57,21,27.88,79,2011,2,8.9981
152,114,38,22,27.06,78,2011,2,15.0013
92,78,14,23,27.06,78,2011,2,12.998
68,48,20,0,27.06,50,2011,3,14.12152564
31,16,15,1,27.06,50,2011,3,14.12152564
13,7,6,2,25.42,69,2011,3,11.99091211
11,6,5,3,26.24,53,2011,3,14.00513459
6,5,1,4,25.42,57,2011,3,13.46000953
30,27,3,5,24.6,64,2011,3,8.9981
108,97,11,6,25.42,61,2011,3,8.9981
243,218,25,7,27.06,54,2011,3,7.0015
492,453,39,8,28.7,42,2011,3,11.0014
260,202,58,9,30.34,35,2011,3,11.0014
170,109,61,10,31.16,33,2011,3,11.0014
214,146,68,11,32.8,26,2011,3,14.40854863
263,180,83,12,32.8,26,2011,3,14.40854863
292,209,83,13,32.8,24,2011,3,16.92257181
303,225,78,14,33.62,23,2011,3,12.998
381,299,82,15,33.62,21,2011,3,16.9979
427,342,85,16,33.62,17,2011,3,15.388948
461,362,99,17,33.62,21,2011,3,12.998
422,324,98,18,32.8,24,2011,3,16.9979
318,238,80,19,31.98,25,2011,3,12.998
269,185,84,20,29.52,42,2011,3,15.0013
218,149,69,21,28.7,45,2011,3,12.998
222,173,49,22,28.7,42,2011,3,14.10260779
140,96,44,23,27.88,47,2011,3,6.0032
115,84,31,0,27.88,47,2011,3,6.0032
78,58,20,1,27.06,54,2011,3,13.76007566
52,43,9,2,26.24,53,2011,3,14.00513459
26,21,5,3,26.24,53,2011,3,14.00513459
11,8,3,4,25.42,61,2011,3,12.83028643
14,13,1,5,23.78,73,2011,3,7.0015
32,21,11,6,25.42,69,2011,3,7.0015
45,35,10,7,26.24,65,2011,3,12.15923533
132,94,38,8,27.88,57,2011,3,13.50801035
179,124,55,9,30.34,51,2011,3,6.0032
271,168,103,10,32.8,36,2011,3,14.94557136
357,213,144,11,32.8,36,2011,3,6.0032
374,232,142,12,33.62,30,2011,3,8.9981
404,226,178,13,33.62,30,2011,3,7.0015
392,215,177,14,34.44,20,2011,3,14.50492398
331,163,168,15,35.26,19,2011,3,11.0014
398,192,206,16,36.08,22,2011,3,15.0013
349,170,179,17,34.44,30,2011,3,15.0013
383,190,193,18,33.62,30,2011,3,19.0012
305,149,156,19,32.8,33,2011,3,15.0013
284,148,136,20,31.16,45,2011,3,19.0012
232,137,95,21,30.34,48,2011,3,12.998
201,123,78,22,29.52,51,2011,3,11.0014
154,88,66,23,29.52,54,2011,3,19.0012
144,97,47,0,28.7,58,2011,3,15.0013
78,55,23,1,28.7,61,2011,3,11.0014
69,50,19,2,28.7,58,2011,3,12.998
33,25,8,3,27.88,65,2011,3,6.0032
5,2,3,4,27.88,65,2011,3,6.0032
1,1,0,5,25.42,83,2011,3,12.998
3,3,0,6,25.42,94,2011,3,6.0032
25,22,3,7,26.24,89,2011,3,12.998
92,53,39,8,27.88,79,2011,3,15.0013
181,99,82,9,28.7,74,2011,3,16.9979
264,133,131,10,30.34,66,2011,3,11.0014
390,175,215,11,31.16,62,2011,3,7.0015
404,206,198,12,32.8,55,2011,3,7.0015
421,173,248,13,32.8,59,2011,3,15.0013
375,150,225,14,33.62,56,2011,3,16.9979
376,182,194,15,34.44,53,2011,3,19.9995
414,219,195,16,34.44,53,2011,3,19.9995
358,177,181,17,32.8,49,2011,3,56.9969
181,107,74,18,32.8,49,2011,3,56.9969
183,83,100,19,27.06,83,2011,3,12.998
176,93,83,20,27.06,83,2011,3,16.74386712
167,92,75,21,27.06,83,2011,3,11.0014
162,93,69,22,27.06,78,2011,3,7.0015
147,77,70,23,26.24,83,2011,3,11.0014
140,77,63,0,26.24,83,2011,3,8.9981
119,76,43,1,26.24,83,2011,3,6.0032
63,30,33,2,26.24,83,2011,3,10.5085257
26,13,13,3,26.24,78,2011,3,10.72825804
12,4,8,4,27.06,78,2011,3,6.0032
4,3,1,5,26.24,83,2011,3,8.9981
16,11,5,6,26.24,89,2011,3,11.0014
36,19,17,7,27.06,83,2011,3,8.9981
86,44,42,8,28.7,74,2011,3,7.0015
238,96,142,9,29.52,66,2011,3,6.0032
280,114,166,10,31.16,55,2011,3,6.0032
349,172,177,11,31.16,55,2011,3,6.0032
447,210,237,12,31.98,52,2011,3,14.7052414
423,181,242,13,31.98,49,2011,3,14.88390911
408,173,235,14,32.8,46,2011,3,15.04840451
408,184,224,15,33.62,43,2011,3,6.0032
452,216,236,16,33.62,41,2011,3,15.19145746
436,196,240,17,32.8,46,2011,3,15.04840451
418,196,222,18,32.8,46,2011,3,8.9981
375,205,170,19,31.98,49,2011,3,11.0014
386,191,195,20,31.16,55,2011,3,7.0015
457,262,195,21,30.34,62,2011,3,7.0015
326,211,115,22,30.34,62,2011,3,8.9981
138,94,44,23,29.52,70,2011,3,7.0015
55,36,19,0,28.7,65,2011,3,11.0014
39,24,15,1,28.7,65,2011,3,7.0015
13,5,8,2,27.06,74,2011,3,6.0032
8,7,1,3,27.06,74,2011,3,15.0013
5,4,1,4,27.06,69,2011,3,11.0014
20,19,1,5,27.06,69,2011,3,12.25716614
94,91,3,6,27.06,74,2011,3,6.0032
270,248,22,7,28.7,65,2011,3,6.0032
432,391,41,8,29.52,62,2011,3,8.9981
227,177,50,9,30.34,58,2011,3,8.9981
139,84,55,10,31.16,52,2011,3,7.0015
172,97,75,11,31.98,46,2011,3,7.0015
201,130,71,12,32.8,43,2011,3,7.0015
203,136,67,13,33.62,43,2011,3,7.0015
178,112,66,14,32.8,49,2011,3,11.0014
162,111,51,15,33.62,43,2011,3,14.95387058
281,202,79,16,33.62,46,2011,3,7.0015
545,466,79,17,33.62,46,2011,3,7.0015
496,426,70,18,32.8,55,2011,3,11.0014
368,297,71,19,32.8,59,2011,3,8.9981
284,225,59,20,31.16,66,2011,3,7.0015
245,168,77,21,31.98,62,2011,3,16.9979
155,124,31,22,31.16,66,2011,3,15.0013
73,54,19,23,30.34,66,2011,3,11.0014
37,26,11,0,29.52,74,2011,3,12.998
15,11,4,1,28.7,74,2011,3,8.9981
5,4,1,2,28.7,79,2011,3,6.0032
6,6,0,3,28.7,79,2011,3,10.63525012
6,6,0,4,27.88,83,2011,3,6.0032
35,30,5,5,27.88,83,2011,3,6.0032
121,112,9,6,28.7,79,2011,3,6.0032
312,288,24,7,29.52,79,2011,3,11.80284693
428,397,31,8,29.52,74,2011,3,7.0015
189,158,31,9,28.7,79,2011,3,12.998
43,30,13,10,28.7,79,2011,3,6.0032
127,103,24,11,29.52,74,2011,3,12.02081786
152,114,38,12,30.34,66,2011,3,6.0032
140,107,33,13,30.34,70,2011,3,7.0015
163,113,50,14,31.16,66,2011,3,19.0012
185,130,55,15,31.16,70,2011,3,19.0012
275,218,57,16,31.16,70,2011,3,16.9979
596,517,79,17,31.98,59,2011,3,15.0013
563,486,77,18,31.16,62,2011,3,12.998
394,323,71,19,30.34,70,2011,3,15.0013
312,257,55,20,29.52,74,2011,3,16.9979
241,175,66,21,28.7,79,2011,3,12.998
186,156,30,22,28.7,79,2011,3,12.998
98,78,20,23,27.88,83,2011,3,15.0013
35,29,6,0,27.06,89,2011,3,8.9981
16,14,2,1,27.06,89,2011,3,12.998
8,7,1,2,27.06,89,2011,3,12.998
4,2,2,3,26.24,94,2011,3,7.0015
4,4,0,4,26.24,89,2011,3,7.0015
32,30,2,5,26.24,89,2011,3,7.0015
118,107,11,6,26.24,89,2011,3,8.9981
292,279,13,7,27.06,89,2011,3,7.0015
443,415,28,8,28.7,79,2011,3,12.998
179,154,25,9,30.34,70,2011,3,11.0014
101,72,29,10,31.98,62,2011,3,12.95368137
142,112,30,11,33.62,52,2011,3,8.9981
171,139,32,12,34.44,41,2011,3,15.18028716
155,107,48,13,35.26,41,2011,3,15.29509547
160,121,39,14,35.26,41,2011,3,16.9979
166,119,47,15,35.26,41,2011,3,16.9979
265,218,47,16,35.26,39,2011,3,15.0013
569,489,80,17,35.26,36,2011,3,16.9979
562,492,70,18,34.44,44,2011,3,19.9995
365,286,79,19,33.62,52,2011,3,19.0012
285,224,61,20,31.16,58,2011,3,23.9994
209,170,39,21,30.34,62,2011,3,11.0014
182,150,32,22,30.34,62,2011,3,11.0014
129,98,31,23,29.52,66,2011,3,12.20816449
47,41,6,0,30.34,66,2011,3,7.0015
34,25,9,1,29.52,79,2011,3,10.34719288
22,12,10,2,28.7,74,2011,3,11.0014
6,4,2,3,27.88,79,2011,3,7.0015
11,4,7,4,28.7,79,2011,3,16.9979
27,24,3,5,27.88,79,2011,3,16.9979
102,91,11,6,28.7,74,2011,3,7.0015
332,302,30,7,28.7,79,2011,3,12.998
457,421,36,8,29.52,74,2011,3,16.9979
241,211,30,9,31.16,70,2011,3,19.9995
138,108,30,10,30.34,70,2011,3,23.9994
165,104,61,11,30.34,74,2011,3,16.9979
213,164,49,12,31.16,70,2011,3,19.0012
229,175,54,13,31.98,66,2011,3,19.0012
216,163,53,14,32.8,63,2011,3,23.9994
141,102,39,15,32.8,63,2011,3,23.9994
132,105,27,16,27.88,83,2011,3,30.0026
167,161,6,17,27.06,89,2011,3,30.0026
316,281,35,18,27.06,83,2011,3,6.0032
270,225,45,19,27.06,83,2011,3,6.0032
250,220,30,20,27.06,83,2011,3,11.0014
204,158,46,21,27.06,83,2011,3,16.9979
169,136,33,22,27.06,78,2011,3,12.998
151,111,40,23,27.06,78,2011,3,6.0032
121,90,31,0,27.06,83,2011,3,8.9981
53,48,5,1,26.24,89,2011,3,7.0015
55,43,12,2,26.24,89,2011,3,11.0014
30,23,7,3,26.24,89,2011,3,8.9981
6,4,2,4,26.24,83,2011,3,15.0013
15,11,4,5,25.42,88,2011,3,11.0014
38,27,11,6,26.24,83,2011,3,12.998
71,50,21,7,27.06,78,2011,3,12.998
182,114,68,8,28.7,70,2011,3,16.9979
247,170,77,9,30.34,58,2011,3,19.0012
264,177,87,10,31.16,52,2011,3,11.0014
290,189,101,11,31.98,46,2011,3,19.9995
366,221,145,12,32.8,46,2011,3,16.9979
416,249,167,13,33.62,41,2011,3,15.0013
373,215,158,14,34.44,36,2011,3,8.9981
402,220,182,15,34.44,34,2011,3,6.0032
416,245,171,16,33.62,38,2011,3,14.95327264
401,241,160,17,34.44,32,2011,3,15.04438445
378,246,132,18,33.62,36,2011,3,7.0015
306,178,128,19,31.16,55,2011,3,11.0014
314,185,129,20,31.16,58,2011,3,15.0013
238,155,83,21,30.34,58,2011,3,11.0014
214,154,60,22,29.52,62,2011,3,11.0014
140,93,47,23,29.52,58,2011,3,12.998
154,112,42,0,28.7,61,2011,3,11.0014
113,94,19,1,28.7,61,2011,3,8.9981
96,68,28,2,27.88,69,2011,3,6.0032
25,19,6,3,27.06,74,2011,3,6.0032
5,5,0,4,27.06,69,2011,3,6.0032
17,10,7,5,27.06,74,2011,3,11.75361885
25,17,8,6,26.24,78,2011,3,6.0032
65,38,27,7,28.7,70,2011,3,6.0032
92,65,27,8,29.52,66,2011,3,12.20816449
169,107,62,9,30.34,66,2011,3,6.0032
268,173,95,10,31.16,55,2011,3,8.9981
287,177,110,11,31.98,55,2011,3,12.998
377,244,133,12,33.62,46,2011,3,19.0012
367,228,139,13,32.8,46,2011,3,19.9995
349,227,122,14,33.62,41,2011,3,22.0028
361,219,142,15,34.44,39,2011,3,19.0012
372,244,128,16,34.44,41,2011,3,19.0012
363,217,146,17,34.44,36,2011,3,15.0013
363,222,141,18,33.62,43,2011,3,19.0012
303,183,120,19,32.8,49,2011,3,22.0028
268,167,101,20,31.16,55,2011,3,12.998
227,162,65,21,30.34,62,2011,3,16.9979
143,87,56,22,30.34,66,2011,3,15.0013
72,53,19,23,29.52,66,2011,3,16.9979
35,25,10,0,28.7,65,2011,3,12.998
10,5,5,1,28.7,61,2011,3,19.0012
12,4,8,2,28.7,61,2011,3,15.0013
10,8,2,3,27.88,65,2011,3,11.0014
4,4,0,4,27.06,74,2011,3,15.0013
26,21,5,5,27.06,74,2011,3,8.9981
121,102,19,6,27.88,74,2011,3,12.998
317,289,28,7,28.7,74,2011,3,16.9979
420,385,35,8,30.34,66,2011,3,19.0012
208,167,41,9,31.98,59,2011,3,19.9995
117,73,44,10,32.8,55,2011,3,23.9994
128,89,39,11,33.62,56,2011,3,19.9995
148,108,40,12,34.44,53,2011,3,19.0012
141,119,22,13,35.26,50,2011,3,16.9979
134,94,40,14,35.26,53,2011,3,19.0012
146,108,38,15,35.26,56,2011,3,27.9993
239,182,57,16,35.26,56,2011,3,26.0027
514,455,59,17,35.26,56,2011,3,27.9993
472,415,57,18,35.26,53,2011,3,26.0027
373,293,80,19,34.44,59,2011,3,22.0028
236,194,42,20,29.52,74,2011,3,27.9993
130,109,21,21,28.7,79,2011,3,27.9993
90,70,20,22,29.52,74,2011,3,8.9981
55,44,11,23,28.7,79,2011,3,8.9981
22,19,3,0,28.7,79,2011,3,8.9981
14,8,6,1,28.7,79,2011,3,6.0032
9,7,2,2,28.7,79,2011,3,7.0015
8,6,2,3,28.7,79,2011,3,11.82000093
6,6,0,4,28.7,79,2011,3,11.0014
25,21,4,5,28.7,79,2011,3,6.0032
115,102,13,6,30.34,58,2011,3,15.0013
330,301,29,7,31.16,55,2011,3,12.998
417,382,35,8,31.16,58,2011,3,15.0013
176,149,27,9,31.98,55,2011,3,32.9975
123,85,38,10,33.62,52,2011,3,11.0014
125,86,39,11,33.62,52,2011,3,11.0014
163,125,38,12,35.26,44,2011,3,19.9995
136,104,32,13,35.26,47,2011,3,15.0013
124,91,33,14,36.9,42,2011,3,19.9995
148,111,37,15,36.9,42,2011,3,23.9994
202,177,25,16,35.26,44,2011,3,19.0012
428,380,48,17,36.08,44,2011,3,19.0012
511,472,39,18,35.26,47,2011,3,19.9995
337,295,42,19,34.44,44,2011,3,19.0012
308,251,57,20,33.62,43,2011,3,12.998
258,209,49,21,33.62,43,2011,3,7.0015
194,150,44,22,32.8,46,2011,3,8.9981
79,59,20,23,31.98,52,2011,3,14.82210957
46,37,9,0,31.16,62,2011,3,12.88230406
12,11,1,1,31.16,55,2011,3,14.04353666
5,3,2,2,31.16,55,2011,3,14.04353666
4,4,0,3,30.34,58,2011,3,12.998
5,5,0,4,30.34,58,2011,3,16.9979
26,22,4,5,30.34,58,2011,3,12.998
121,103,18,6,30.34,58,2011,3,11.0014
313,281,32,7,31.16,55,2011,3,16.9979
449,418,31,8,32.8,49,2011,3,16.9979
186,163,23,9,33.62,41,2011,3,12.998
113,80,33,10,33.62,46,2011,3,12.998
165,110,55,11,34.44,39,2011,3,11.0014
174,134,40,12,34.44,41,2011,3,19.0012
158,119,39,13,33.62,46,2011,3,8.9981
116,89,27,14,33.62,46,2011,3,8.9981
46,33,13,15,26.24,94,2011,3,8.9981
141,118,23,16,27.06,89,2011,3,10.74602744
488,418,70,17,28.7,79,2011,3,10.63525012
463,412,51,18,29.52,79,2011,3,8.9981
419,340,79,19,28.7,79,2011,3,7.0015
342,281,61,20,28.7,84,2011,3,11.0014
250,194,56,21,28.7,79,2011,3,7.0015
184,136,48,22,27.88,83,2011,3,12.998
116,83,33,23,27.06,83,2011,3,16.9979
46,32,14,0,27.06,69,2011,3,19.9995
25,21,4,1,27.06,61,2011,3,16.9979
10,7,3,2,26.24,57,2011,3,19.9995
6,5,1,3,25.42,57,2011,3,19.9995
6,6,0,4,25.42,53,2011,3,16.9979
28,22,6,5,24.6,56,2011,3,15.0013
130,116,14,6,24.6,60,2011,3,15.0013
334,311,23,7,25.42,53,2011,3,16.9979
486,433,53,8,26.24,50,2011,3,23.9994
224,195,29,9,27.88,47,2011,3,19.0012
127,95,32,10,28.7,42,2011,3,16.9979
148,110,38,11,29.52,37,2011,3,15.0013
223,172,51,12,30.34,35,2011,3,16.9979
177,138,39,13,31.16,33,2011,3,22.0028
178,129,49,14,30.34,35,2011,3,19.0012
180,138,42,15,31.16,33,2011,3,19.9995
274,231,43,16,31.16,33,2011,3,8.9981
595,517,78,17,30.34,37,2011,3,8.9981
578,484,94,18,29.52,42,2011,3,12.998
400,333,67,19,29.52,39,2011,3,15.0013
348,267,81,20,28.7,42,2011,3,15.0013
261,203,58,21,27.06,50,2011,3,8.9981
176,134,42,22,26.24,57,2011,3,6.0032
124,97,27,23,26.24,65,2011,3,16.9979
80,57,23,0,25.42,73,2011,3,15.0013
20,13,7,1,25.42,73,2011,3,12.998
38,22,16,2,24.6,78,2011,3,11.0014
7,6,1,3,24.6,73,2011,3,12.998
10,8,2,4,24.6,73,2011,3,11.0014
23,16,7,5,24.6,73,2011,3,8.9981
120,108,12,6,24.6,73,2011,3,7.0015
274,257,17,7,26.24,65,2011,3,7.0015
564,514,50,8,26.24,65,2011,3,16.9979
207,176,31,9,27.88,54,2011,3,12.998
166,107,59,10,27.06,61,2011,3,11.0014
210,137,73,11,28.7,54,2011,3,8.9981
238,177,61,12,28.7,48,2011,3,12.998
247,162,85,13,28.7,54,2011,3,12.998
265,160,105,14,28.7,51,2011,3,12.998
237,163,74,15,29.52,45,2011,3,11.0014
361,265,96,16,29.52,51,2011,3,12.998
587,483,104,17,30.34,42,2011,3,16.9979
496,394,102,18,29.52,45,2011,3,15.0013
394,280,114,19,28.7,45,2011,3,15.0013
343,251,92,20,28.7,51,2011,3,15.0013
261,186,75,21,27.06,54,2011,3,7.0015
223,152,71,22,27.06,57,2011,3,15.0013
167,126,41,23,26.24,61,2011,3,11.0014
110,68,42,0,25.42,65,2011,3,12.998
75,51,24,1,24.6,69,2011,3,7.0015
58,48,10,2,24.6,73,2011,3,8.9981
26,20,6,3,24.6,78,2011,3,8.9981
16,7,9,4,24.6,73,2011,3,6.0032
10,6,4,5,23.78,78,2011,3,6.0032
37,21,16,6,24.6,78,2011,3,11.0014
52,38,14,7,25.42,73,2011,3,8.9981
127,90,37,8,27.06,65,2011,3,11.0014
222,150,72,9,28.7,54,2011,3,15.0013
322,208,114,10,29.52,54,2011,3,12.998
396,225,171,11,30.34,48,2011,3,15.0013
463,276,187,12,31.16,43,2011,3,19.0012
497,276,221,13,31.16,45,2011,3,19.9995
433,232,201,14,30.34,45,2011,3,19.9995
428,223,205,15,31.16,45,2011,3,22.0028
425,242,183,16,31.16,45,2011,3,19.0012
475,241,234,17,31.16,45,2011,3,15.0013
428,243,185,18,31.16,45,2011,3,19.0012
406,242,164,19,30.34,48,2011,3,12.998
296,188,108,20,29.52,51,2011,3,15.0013
252,167,85,21,28.7,58,2011,3,15.0013
201,136,65,22,28.7,65,2011,3,19.0012
168,107,61,23,27.88,61,2011,3,15.0013
125,91,34,0,27.06,65,2011,3,15.0013
102,86,16,1,26.24,69,2011,3,12.998
94,66,28,2,26.24,69,2011,3,15.0013
47,26,21,3,26.24,69,2011,3,15.0013
10,6,4,4,25.42,73,2011,3,11.0014
12,8,4,5,26.24,69,2011,3,15.0013
21,11,10,6,25.42,73,2011,3,11.0014
50,30,20,7,26.24,73,2011,3,11.0014
118,73,45,8,27.88,65,2011,3,15.0013
184,110,74,9,29.52,58,2011,3,15.0013
304,177,127,10,30.34,60,2011,3,15.0013
391,244,147,11,31.16,55,2011,3,19.0012
420,243,177,12,31.16,55,2011,3,19.0012
472,272,200,13,32.8,49,2011,3,19.9995
430,262,168,14,32.8,49,2011,3,23.9994
324,195,129,15,33.62,43,2011,3,19.9995
317,188,129,16,32.8,46,2011,3,19.9995
369,236,133,17,32.8,49,2011,3,26.0027
390,243,147,18,32.8,46,2011,3,19.9995
379,234,145,19,31.16,55,2011,3,19.0012
262,177,85,20,31.16,58,2011,3,16.9979
207,148,59,21,30.34,62,2011,3,15.0013
181,116,65,22,29.52,66,2011,3,15.0013
93,54,39,23,28.7,74,2011,3,8.9981
51,30,21,0,28.7,74,2011,3,8.9981
25,8,17,1,28.7,74,2011,3,15.0013
10,8,2,2,27.06,83,2011,3,15.0013
7,4,3,3,27.06,78,2011,3,12.998
4,3,1,4,26.24,78,2011,3,11.0014
17,15,2,5,26.24,78,2011,3,7.0015
105,95,10,6,26.24,83,2011,3,7.0015
277,255,22,7,27.88,74,2011,3,15.0013
347,329,18,8,28.7,70,2011,3,12.998
203,170,33,9,30.34,67,2011,3,15.0013
130,78,52,10,31.16,62,2011,3,12.998
141,99,42,11,32.8,55,2011,3,6.0032
165,126,39,12,32.8,59,2011,3,12.998
152,125,27,13,33.62,56,2011,3,16.9979
138,106,32,14,33.62,56,2011,3,22.0028
164,111,53,15,34.44,53,2011,3,22.0028
265,220,45,16,34.44,53,2011,3,19.0012
545,473,72,17,34.44,49,2011,3,22.0028
558,478,80,18,33.62,49,2011,3,23.9994
398,335,63,19,32.8,55,2011,3,15.0013
323,232,91,20,31.98,59,2011,3,15.0013
202,154,48,21,30.34,66,2011,3,12.998
140,104,36,22,31.16,66,2011,3,15.0013
91,59,32,23,30.34,66,2011,3,11.0014
51,26,25,0,30.34,66,2011,3,7.0015
13,6,7,1,30.34,66,2011,3,8.9981
13,4,9,2,29.52,70,2011,3,11.0014
3,1,2,3,29.52,70,2011,3,11.0014
5,4,1,4,29.52,70,2011,3,8.9981
19,19,0,5,28.7,74,2011,3,7.0015
134,126,8,6,29.52,74,2011,3,7.0015
315,287,28,7,30.34,70,2011,3,11.0014
412,381,31,8,31.16,70,2011,3,11.0014
199,177,22,9,32.8,63,2011,3,8.9981
141,112,29,10,33.62,56,2011,3,11.0014
127,98,29,11,33.62,59,2011,3,13.86852978
153,127,26,12,34.44,56,2011,3,6.0032
172,139,33,13,35.26,53,2011,3,7.0015
152,111,41,14,35.26,50,2011,3,12.998
158,110,48,15,36.08,44,2011,3,12.998
277,216,61,16,36.9,42,2011,3,19.9995
513,445,68,17,32.8,66,2011,3,12.08457583
530,450,80,18,32.8,66,2011,3,8.9981
388,334,54,19,31.16,75,2011,3,12.998
277,229,48,20,30.34,74,2011,3,6.0032
241,194,47,21,30.34,74,2011,3,8.9981
156,120,36,22,30.34,74,2011,3,11.87967398
92,73,19,23,29.52,79,2011,3,11.0014
29,22,7,0,29.52,70,2011,3,15.0013
17,12,5,1,29.52,74,2011,3,12.998
11,7,4,2,28.7,74,2011,3,7.0015
4,4,0,3,28.7,79,2011,3,11.0014
4,2,2,4,27.06,83,2011,3,8.9981
26,24,2,5,27.06,83,2011,3,7.0015
100,97,3,6,27.06,83,2011,3,6.0032
282,258,24,7,30.34,62,2011,3,13.76075175
382,347,35,8,32.8,43,2011,3,12.998
166,139,27,9,33.62,41,2011,3,15.56452564
97,70,27,10,35.26,36,2011,3,11.0014
119,66,53,11,36.08,32,2011,3,11.0014
168,115,53,12,36.9,33,2011,3,16.9979
150,112,38,13,36.9,31,2011,3,19.9995
123,86,37,14,37.72,29,2011,3,12.998
129,77,52,15,36.9,27,2011,3,16.92866735
231,197,34,16,36.9,27,2011,3,16.92866735
514,445,69,17,31.16,45,2011,3,19.9995
543,475,68,18,31.98,43,2011,3,12.998
413,350,63,19,30.34,51,2011,3,15.0013
305,256,49,20,29.52,62,2011,3,15.0013
220,178,42,21,28.7,70,2011,3,16.9979
137,116,21,22,28.7,70,2011,3,6.0032
96,82,14,23,27.88,74,2011,3,12.998
29,18,11,0,27.06,74,2011,3,12.16043156
12,8,4,1,27.06,74,2011,3,7.0015
8,6,2,2,27.88,69,2011,3,12.93160361
5,5,0,3,27.06,74,2011,3,12.998
10,10,0,4,27.06,74,2011,3,7.0015
21,17,4,5,27.06,74,2011,3,8.9981
117,105,12,6,27.88,69,2011,3,7.0015
335,320,15,7,29.52,61,2011,3,19.0012
435,398,37,8,30.34,58,2011,3,19.0012
213,182,31,9,31.98,46,2011,3,19.9995
140,90,50,10,33.62,36,2011,3,19.9995
128,96,32,11,34.44,32,2011,3,27.9993
157,112,45,12,35.26,30,2011,3,19.0012
203,153,50,13,35.26,30,2011,3,15.0013
159,114,45,14,36.9,25,2011,3,19.0012
168,120,48,15,36.9,25,2011,3,19.0012
274,216,58,16,36.9,25,2011,3,19.0012
556,493,63,17,36.9,27,2011,3,8.9981
556,491,65,18,35.26,34,2011,3,12.998
454,369,85,19,35.26,36,2011,3,15.0013
288,248,40,20,33.62,46,2011,3,16.9979
254,201,53,21,32.8,52,2011,3,15.0013
191,169,22,22,31.98,59,2011,3,11.0014
132,103,29,23,32.8,49,2011,3,11.0014
43,32,11,0,32.8,49,2011,3,11.0014
16,9,7,1,31.98,52,2011,3,11.0014
11,9,2,2,31.98,49,2011,3,11.0014
4,4,0,3,31.16,55,2011,3,6.0032
7,7,0,4,31.16,52,2011,3,11.0014
24,22,2,5,31.16,55,2011,3,6.0032
110,101,9,6,29.52,66,2011,3,32.9975
271,252,19,7,30.34,51,2011,3,15.0013
437,408,29,8,30.34,51,2011,3,11.0014
195,172,23,9,30.34,55,2011,3,12.998
68,59,9,10,30.34,58,2011,3,6.0032
122,93,29,11,30.34,58,2011,3,7.0015
161,142,19,12,31.16,55,2011,3,8.9981
144,107,37,13,31.16,58,2011,3,15.0013
147,104,43,14,31.16,58,2011,3,15.0013
118,87,31,15,28.7,79,2011,3,8.9981
150,129,21,16,27.88,79,2011,3,17.17088409
425,378,47,17,28.7,79,2011,3,15.24813624
492,443,49,18,28.7,84,2011,3,17.4667475
321,270,51,19,28.7,84,2011,3,17.4667475
87,80,7,20,28.7,84,2011,3,7.0015
88,81,7,21,27.88,89,2011,3,8.9981
77,66,11,22,27.88,89,2011,3,7.0015
56,52,4,23,27.88,89,2011,3,6.0032
17,15,2,0,27.88,89,2011,3,6.0032
17,14,3,1,27.06,94,2011,3,6.0032
7,5,2,2,27.06,94,2011,3,6.0032
3,3,0,3,27.06,94,2011,3,6.0032
7,7,0,4,27.88,89,2011,3,12.05853204
20,17,3,5,27.88,89,2011,3,12.05853204
97,90,7,6,27.88,89,2011,3,19.9995
282,271,11,7,27.88,89,2011,3,19.9995
398,369,29,8,28.7,82,2011,3,23.9994
187,162,25,9,29.52,74,2011,3,22.0028
113,89,24,10,29.52,71,2011,3,19.9995
149,112,37,11,30.34,66,2011,3,15.0013
205,152,53,12,31.16,62,2011,3,15.0013
205,142,63,13,31.16,58,2011,3,14.61519122
167,114,53,14,32.8,55,2011,3,11.0014
165,115,50,15,32.8,55,2011,3,16.9979
290,220,70,16,31.16,62,2011,3,22.0028
555,464,91,17,31.16,62,2011,3,22.0028
523,435,88,18,28.7,74,2011,3,19.9995
366,301,65,19,28.7,74,2011,3,19.0012
286,245,41,20,28.7,74,2011,3,12.998
211,186,25,21,28.7,74,2011,3,12.998
174,141,33,22,27.88,74,2011,3,12.998
132,108,24,23,27.06,74,2011,3,7.0015
54,41,13,0,27.06,74,2011,3,7.0015
19,16,3,1,26.24,78,2011,3,6.0032
19,14,5,2,27.06,69,2011,3,12.53751445
6,6,0,3,26.24,78,2011,3,6.0032
7,6,1,4,26.24,78,2011,3,8.9981
16,16,0,5,26.24,78,2011,3,6.0032
101,94,7,6,26.24,78,2011,3,8.9981
270,247,23,7,27.06,78,2011,3,8.9981
454,415,39,8,28.7,65,2011,3,15.0013
226,183,43,9,29.52,58,2011,3,7.0015
163,113,50,10,30.34,55,2011,3,8.9981
147,103,44,11,31.16,52,2011,3,16.9979
216,159,57,12,31.16,52,2011,3,16.9979
204,164,40,13,31.98,52,2011,3,16.9979
245,164,81,14,31.98,52,2011,3,16.9979
210,160,50,15,31.16,55,2011,3,16.9979
330,254,76,16,32.8,49,2011,3,16.9979
550,466,84,17,31.98,49,2011,3,19.9995
466,361,105,18,31.16,52,2011,3,16.9979
372,282,90,19,30.34,55,2011,3,16.9979
291,221,70,20,29.52,58,2011,3,15.0013
173,119,54,21,28.7,65,2011,3,12.998
188,137,51,22,28.7,65,2011,3,15.0013
139,102,37,23,27.88,69,2011,3,15.0013
133,104,29,0,27.06,78,2011,3,12.998
67,50,17,1,27.06,78,2011,3,11.0014
53,39,14,2,27.06,78,2011,3,15.0013
42,28,14,3,27.06,78,2011,3,11.0014
10,5,5,4,27.06,83,2011,3,11.0014
6,4,2,5,26.24,89,2011,3,6.0032
27,22,5,6,26.24,89,2011,3,7.0015
63,49,14,7,27.88,83,2011,3,11.0014
121,94,27,8,27.88,83,2011,3,11.0014
215,155,60,9,30.34,70,2011,3,15.0013
290,199,91,10,30.34,70,2011,3,19.0012
349,211,138,11,31.98,62,2011,3,15.0013
382,252,130,12,32.8,55,2011,3,15.0013
441,265,176,13,32.8,59,2011,3,22.0028
380,204,176,14,33.62,52,2011,3,16.9979
362,232,130,15,34.44,53,2011,3,16.9979
343,188,155,16,30.34,79,2011,3,11.0014
149,88,61,17,30.34,79,2011,3,11.0014
211,130,81,18,29.52,79,2011,3,30.0026
171,114,57,19,29.52,84,2011,3,16.9979
137,79,58,20,29.52,79,2011,3,19.0012
114,86,28,21,28.7,84,2011,3,22.0028
120,96,24,22,28.7,84,2011,3,22.0028
108,79,29,23,28.7,84,2011,3,19.0012
80,66,14,0,28.7,84,2011,3,19.0012
73,63,10,1,28.7,84,2011,3,16.9979
66,48,18,2,28.7,84,2011,3,15.0013
32,23,9,3,28.7,84,2011,3,8.9981
6,5,1,4,28.7,84,2011,3,8.9981
5,4,1,5,28.7,89,2011,3,12.998
13,10,3,6,28.7,89,2011,3,11.0014
39,28,11,7,28.7,84,2011,3,12.998
89,66,23,8,29.52,79,2011,3,12.998
184,102,82,9,31.16,75,2011,3,7.0015
266,178,88,10,32.8,66,2011,3,8.9981
269,156,113,11,33.62,63,2011,3,14.39981369
370,209,161,12,36.9,42,2011,3,19.9995
324,206,118,13,36.9,42,2011,3,19.9995
322,192,130,14,35.26,47,2011,3,12.998
326,208,118,15,29.52,74,2011,3,19.9995
193,119,74,16,29.52,74,2011,3,19.9995
194,131,63,17,30.34,74,2011,3,43.0006
229,155,74,18,29.52,74,2011,3,6.0032
228,160,68,19,29.52,79,2011,3,11.0014
183,133,50,20,29.52,84,2011,3,8.9981
136,100,36,21,29.52,84,2011,3,7.0015
103,82,21,22,28.7,89,2011,3,12.998
55,43,12,23,28.7,79,2011,3,7.0015
30,17,13,0,28.7,79,2011,3,7.0015
12,8,4,1,27.88,83,2011,3,8.9981
7,3,4,2,27.06,89,2011,3,10.34649565
1,0,1,3,27.06,89,2011,3,10.34649565
10,8,2,4,27.06,89,2011,3,7.0015
15,14,1,5,28.7,79,2011,3,6.0032
95,87,8,6,28.7,65,2011,3,19.0012
267,249,18,7,29.52,62,2011,3,19.9995
349,320,29,8,30.34,58,2011,3,22.0028
183,146,37,9,31.16,55,2011,3,26.0027
124,62,62,10,32.8,52,2011,3,26.0027
179,89,90,11,33.62,48,2011,3,23.9994
182,134,48,12,33.62,46,2011,3,16.9979
151,108,43,13,34.44,44,2011,3,19.9995
150,109,41,14,33.62,43,2011,3,19.9995
126,86,40,15,34.44,41,2011,3,19.9995
282,218,64,16,35.26,39,2011,3,19.0012
527,460,67,17,35.26,39,2011,3,11.0014
529,465,64,18,34.44,41,2011,3,8.9981
416,352,64,19,33.62,43,2011,3,7.0015
286,215,71,20,32.8,55,2011,3,14.94701003
186,156,30,21,31.16,58,2011,3,6.0032
147,121,26,22,31.16,58,2011,3,7.0015
72,53,19,23,30.34,66,2011,3,7.0015
35,25,10,0,29.52,79,2011,3,8.9981
14,9,5,1,29.52,66,2011,3,12.77014086
12,3,9,2,29.52,70,2011,3,12.90510119
3,3,0,3,29.52,62,2011,3,13.75946499
7,6,1,4,28.7,74,2011,3,12.61512565
30,25,5,5,28.7,65,2011,3,6.0032
101,95,6,6,29.52,64,2011,3,13.13786161
343,313,30,7,29.52,74,2011,3,7.0015
392,352,40,8,30.34,66,2011,3,13.07397383
175,141,34,9,31.98,62,2011,3,8.9981
144,89,55,10,32.8,59,2011,3,15.0013
149,88,61,11,32.8,59,2011,3,15.0013
185,125,60,12,33.62,56,2011,3,12.998
175,127,48,13,34.44,49,2011,3,11.0014
148,95,53,14,35.26,44,2011,3,19.0012
164,106,58,15,35.26,39,2011,3,19.0012
285,228,57,16,35.26,39,2011,3,19.9995
532,453,79,17,32.8,55,2011,3,11.0014
585,488,97,18,32.8,55,2011,3,12.998
371,302,69,19,32.8,49,2011,3,7.0015
292,258,34,20,32.8,43,2011,3,12.998
230,184,46,21,31.98,46,2011,3,16.9979
155,127,28,22,31.98,46,2011,3,19.9995
75,53,22,23,31.16,48,2011,3,19.0012
37,18,19,0,30.34,51,2011,3,15.0013
17,10,7,1,29.52,54,2011,3,12.998
11,10,1,2,29.52,54,2011,3,11.0014
4,3,1,3,28.7,58,2011,3,11.0014
5,4,1,4,28.7,54,2011,3,8.9981
32,30,2,5,27.88,61,2011,3,6.0032
119,110,9,6,27.88,61,2011,3,13.67097772
305,289,16,7,28.7,58,2011,3,6.0032
399,361,38,8,30.34,51,2011,3,12.998
180,148,32,9,31.16,48,2011,3,15.0013
113,72,41,10,32.8,43,2011,3,15.0013
149,95,54,11,32.8,41,2011,3,26.0027
240,166,74,12,33.62,38,2011,3,19.9995
191,150,41,13,33.62,38,2011,3,19.0012
178,116,62,14,34.44,34,2011,3,22.0028
194,141,53,15,35.26,30,2011,3,22.0028
282,206,76,16,35.26,26,2011,3,19.9995
584,513,71,17,34.44,26,2011,3,19.9995
559,489,70,18,33.62,28,2011,3,19.9995
413,334,79,19,32.8,26,2011,3,16.9979
312,253,59,20,31.16,31,2011,3,8.9981
209,162,47,21,31.16,33,2011,3,7.0015
139,122,17,22,30.34,37,2011,3,13.91771108
108,94,14,23,30.34,37,2011,3,6.0032
46,40,6,0,28.7,45,2011,3,7.0015
26,17,9,1,28.7,45,2011,3,8.9981
11,8,3,2,27.06,54,2011,3,8.9981
9,7,2,3,26.24,57,2011,3,8.9981
5,4,1,4,26.24,57,2011,3,11.0014
25,23,2,5,26.24,61,2011,3,12.998
106,101,5,6,25.42,65,2011,3,11.0014
307,292,15,7,27.06,54,2011,3,8.9981
390,361,29,8,28.7,45,2011,3,11.0014
197,166,31,9,29.52,39,2011,3,15.0013
132,96,36,10,30.34,37,2011,3,16.9979
187,128,59,11,31.16,35,2011,3,16.9979
214,164,50,12,31.98,31,2011,3,16.9979
217,166,51,13,31.16,31,2011,3,15.0013
142,103,39,14,32.8,29,2011,3,14.83774332
178,126,52,15,32.8,29,2011,3,19.9995
298,241,57,16,32.8,27,2011,3,12.998
582,486,96,17,32.8,29,2011,3,16.9979
571,497,74,18,31.98,29,2011,3,6.0032
371,323,48,19,30.34,35,2011,3,12.998
288,232,56,20,29.52,37,2011,3,8.9981
206,171,35,21,28.7,48,2011,3,6.0032
157,123,34,22,28.7,48,2011,3,13.58435894
127,105,22,23,27.06,50,2011,3,11.0014
65,53,12,0,26.24,53,2011,3,11.0014
23,19,4,1,26.24,53,2011,3,8.9981
15,15,0,2,25.42,57,2011,3,12.998
9,9,0,3,25.42,53,2011,3,11.0014
5,5,0,4,25.42,53,2011,3,8.9981
26,24,2,5,24.6,56,2011,3,8.9981
76,73,3,6,25.42,50,2011,3,8.9981
264,247,17,7,26.24,44,2011,3,11.0014
426,397,29,8,27.88,39,2011,3,15.0013
205,178,27,9,29.52,34,2011,3,8.9981
130,86,44,10,30.34,33,2011,3,7.0015
156,108,48,11,31.16,29,2011,3,15.0458244
222,167,55,12,32.8,27,2011,3,16.41396399
253,179,74,13,31.98,29,2011,3,6.0032
186,135,51,14,32.8,29,2011,3,12.998
249,190,59,15,32.8,29,2011,3,11.0014
334,266,68,16,33.62,28,2011,3,16.54042438
516,423,93,17,33.62,26,2011,3,17.42803816
465,376,89,18,31.16,40,2011,3,19.9995
385,284,101,19,30.34,42,2011,3,15.0013
287,210,77,20,29.52,42,2011,3,15.0013
226,153,73,21,28.7,48,2011,3,8.9981
231,157,74,22,27.88,51,2011,3,13.84738666
151,100,51,23,27.88,51,2011,3,13.84738666
84,69,15,0,27.88,51,2011,3,7.0015
77,64,13,1,27.88,57,2011,3,6.0032
74,58,16,2,27.88,57,2011,3,13.93482628
27,18,9,3,27.06,65,2011,3,8.9981
10,5,5,4,26.24,73,2011,3,8.9981
18,15,3,5,26.24,73,2011,3,7.0015
22,19,3,6,26.24,73,2011,3,6.0032
44,34,10,7,27.06,74,2011,3,12.998
118,90,28,8,28.7,65,2011,3,11.0014
208,138,70,9,28.7,74,2011,3,11.0014
260,163,97,10,29.52,74,2011,3,15.0013
314,192,122,11,30.34,70,2011,3,12.998
421,246,175,12,27.06,89,2011,3,11.0014
153,92,61,13,30.34,74,2011,3,22.0028
259,146,113,14,30.34,70,2011,3,16.9979
358,208,150,15,27.88,79,2011,3,23.9994
281,133,148,16,28.7,74,2011,3,19.0012
269,172,97,17,29.52,74,2011,3,16.9979
292,169,123,18,28.7,74,2011,3,15.0013
237,170,67,19,27.88,79,2011,3,19.0012
183,105,78,20,27.88,83,2011,3,15.0013
167,127,40,21,27.88,83,2011,3,26.0027
154,118,36,22,27.88,83,2011,3,26.0027
120,95,25,23,27.06,83,2011,3,22.0028
90,71,19,0,27.06,83,2011,3,19.9995
73,57,16,1,26.24,89,2011,3,15.0013
62,49,13,2,26.24,89,2011,3,15.0013
27,22,5,3,26.24,94,2011,3,16.9979
3,2,1,4,26.24,94,2011,3,12.998
10,9,1,5,26.24,94,2011,3,11.0014
6,4,2,6,26.24,94,2011,3,7.0015
24,20,4,7,27.06,89,2011,3,12.998
41,21,20,8,27.06,89,2011,3,19.0012
103,76,27,9,27.06,89,2011,3,19.0012
183,116,67,10,28.7,79,2011,3,15.0013
198,117,81,11,28.7,79,2011,3,12.998
281,183,98,12,28.7,79,2011,3,15.0013
377,233,144,13,29.52,74,2011,3,16.9979
370,244,126,14,30.34,70,2011,3,12.998
331,203,128,15,30.34,66,2011,3,12.998
292,176,116,16,30.34,66,2011,3,11.0014
329,196,133,17,31.16,62,2011,3,8.9981
347,222,125,18,30.34,66,2011,3,11.0014
259,184,75,19,29.52,74,2011,3,15.0013
193,126,67,20,28.7,84,2011,3,11.0014
155,104,51,21,24.6,88,2011,3,32.9975
39,25,14,22,24.6,88,2011,3,32.9975
27,22,5,23,24.6,83,2011,3,18.22306467
25,18,7,0,24.6,88,2011,3,6.0032
10,9,1,1,24.6,88,2011,3,8.9981
3,3,0,2,24.6,83,2011,3,12.026657
7,6,1,3,24.6,83,2011,3,12.998
5,4,1,4,24.6,83,2011,3,8.9981
17,14,3,5,24.6,88,2011,3,12.998
90,87,3,6,24.6,88,2011,3,16.9979
258,248,10,7,24.6,88,2011,3,16.9979
355,326,29,8,26.24,78,2011,3,22.0028
222,170,52,9,26.24,78,2011,3,22.0028
141,87,54,10,27.88,69,2011,3,19.0012
153,112,41,11,29.52,62,2011,3,16.9979
178,116,62,12,30.34,58,2011,3,19.0012
193,140,53,13,31.98,52,2011,3,19.0012
151,95,56,14,30.34,55,2011,3,6.0032
182,133,49,15,30.34,55,2011,3,19.9995
283,225,58,16,30.34,55,2011,3,22.0028
530,471,59,17,30.34,51,2011,3,19.0012
483,413,70,18,28.7,65,2011,3,12.998
397,343,54,19,28.7,65,2011,3,12.7850725
285,240,45,20,27.06,74,2011,3,8.9981
184,150,34,21,27.06,65,2011,3,12.998
98,76,22,22,27.06,69,2011,3,16.9979
88,77,11,23,26.24,69,2011,3,15.0013
31,23,8,0,26.24,69,2011,3,7.0015
16,12,4,1,26.24,69,2011,3,11.0014
4,3,1,2,25.42,73,2011,3,15.0013
6,5,1,3,25.42,73,2011,3,15.0013
5,5,0,4,26.24,69,2011,3,19.9995
30,29,1,5,25.42,73,2011,3,19.0012
119,115,4,6,25.42,73,2011,3,22.0028
346,328,18,7,26.24,69,2011,3,16.9979
441,417,24,8,28.7,58,2011,3,30.0026
198,171,27,9,27.88,61,2011,3,19.0012
111,83,28,10,28.7,58,2011,3,26.0027
150,110,40,11,30.34,51,2011,3,15.0013
162,120,42,12,31.16,48,2011,3,22.0028
192,147,45,13,31.16,48,2011,3,19.9995
182,117,65,14,31.16,45,2011,3,27.9993
159,123,36,15,32.8,41,2011,3,19.9995
303,248,55,16,32.8,41,2011,3,15.0013
600,525,75,17,31.16,45,2011,3,22.0028
570,516,54,18,31.16,45,2011,3,15.0013
376,320,56,19,30.34,48,2011,3,12.998
280,232,48,20,30.34,51,2011,3,14.00976654
215,177,38,21,29.52,54,2011,3,14.11211948
152,121,31,22,28.7,61,2011,3,13.73343474
77,57,20,23,27.06,65,2011,3,8.9981
24,16,8,0,27.06,69,2011,3,6.0032
14,12,2,1,26.24,73,2011,3,11.0014
6,6,0,2,27.06,69,2011,3,12.53751445
5,4,1,3,26.24,78,2011,3,10.87941209
5,5,0,4,26.24,73,2011,3,11.85505071
28,28,0,5,26.24,73,2011,3,11.85505071
105,101,4,6,25.42,78,2011,3,10.81976703
308,296,12,7,27.06,65,2011,3,6.0032
487,452,35,8,28.7,54,2011,3,11.0014
209,178,31,9,30.34,48,2011,3,6.0032
118,91,27,10,31.16,43,2011,3,6.0032
128,108,20,11,31.98,43,2011,3,7.0015
189,163,26,12,32.8,43,2011,3,19.0012
176,138,38,13,32.8,41,2011,3,12.998
192,138,54,14,33.62,36,2011,3,11.0014
159,117,42,15,32.8,43,2011,3,8.9981
300,238,62,16,33.62,43,2011,3,15.0013
552,506,46,17,32.8,49,2011,3,15.0013
556,470,86,18,31.16,55,2011,3,16.9979
347,297,50,19,31.16,55,2011,3,15.0013
280,243,37,20,30.34,58,2011,3,16.9979
230,192,38,21,29.52,62,2011,3,15.0013
171,142,29,22,28.7,65,2011,3,12.998
105,85,20,23,28.7,65,2011,3,19.0012
56,38,18,0,27.88,65,2011,3,8.9981
24,11,13,1,27.06,65,2011,3,11.0014
6,4,2,2,27.06,65,2011,3,15.0013
6,6,0,3,27.06,69,2011,3,19.0012
9,9,0,4,26.24,73,2011,3,15.0013
27,27,0,5,26.24,78,2011,3,19.0012
103,97,6,6,26.24,78,2011,3,16.9979
308,289,19,7,26.24,78,2011,3,19.9995
420,393,27,8,27.06,74,2011,3,19.0012
228,186,42,9,29.52,66,2011,3,16.9979
129,92,37,10,30.34,66,2011,3,16.9979
141,97,44,11,31.16,58,2011,3,16.9979
173,139,34,12,32.8,52,2011,3,19.0012
187,154,33,13,32.8,52,2011,3,23.9994
182,115,67,14,33.62,46,2011,3,22.0028
174,118,56,15,32.8,46,2011,3,23.9994
245,196,49,16,32.8,46,2011,3,23.9994
409,365,44,17,32.8,46,2011,3,19.9995
274,226,48,18,31.16,55,2011,3,16.9979
141,115,26,19,27.06,83,2011,3,7.0015
165,141,24,20,27.06,83,2011,3,7.0015
149,137,12,21,27.88,79,2011,3,14.8432494
135,117,18,22,28.7,74,2011,3,7.0015
114,94,20,23,28.7,74,2011,3,8.9981
62,53,9,0,27.88,69,2011,3,12.998
20,19,1,1,26.24,89,2011,3,22.77231376
8,8,0,2,26.24,83,2011,3,18.57176974
3,1,2,3,26.24,78,2011,3,10.87941209
8,7,1,4,26.24,83,2011,3,10.57010224
17,16,1,5,26.24,83,2011,3,10.57010224
93,91,2,6,26.24,83,2011,3,10.57010224
263,251,12,7,27.06,83,2011,3,6.0032
398,368,30,8,27.06,83,2011,3,13.25336561
218,187,31,9,28.7,65,2011,3,8.9981
165,108,57,10,29.52,62,2011,3,6.0032
165,120,45,11,29.52,66,2011,3,6.0032
222,168,54,12,30.34,62,2011,3,6.0032
232,169,63,13,31.16,62,2011,3,12.998
220,142,78,14,31.98,55,2011,3,12.998
222,156,66,15,32.8,49,2011,3,7.0015
327,261,66,16,32.8,49,2011,3,15.30065387
527,442,85,17,31.16,58,2011,3,35.0008
425,337,88,18,31.16,58,2011,3,35.0008
165,132,33,19,25.42,73,2011,3,31.0009
58,46,12,20,25.42,83,2011,3,19.9995
107,89,18,21,25.42,83,2011,3,8.9981
122,97,25,22,24.6,88,2011,3,8.9981
106,88,18,23,24.6,88,2011,3,6.0032
51,33,18,0,24.6,78,2011,3,7.0015
21,14,7,1,24.6,73,2011,3,6.0032
25,11,14,2,23.78,78,2011,3,6.0032
14,7,7,3,23.78,78,2011,3,6.0032
7,7,0,4,22.96,83,2011,3,6.0032
23,22,1,5,22.96,73,2011,3,6.0032
105,103,2,6,24.6,78,2011,3,10.63816323
342,335,7,7,24.6,78,2011,3,10.63816323
498,467,31,8,25.42,73,2011,3,8.9981
207,178,29,9,26.24,69,2011,3,7.0015
138,92,46,10,27.88,61,2011,3,8.9981
192,141,51,11,29.52,51,2011,3,8.9981
229,165,64,12,29.52,51,2011,3,8.9981
219,169,50,13,29.52,48,2011,3,6.0032
198,144,54,14,29.52,54,2011,3,16.9979
174,135,39,15,29.52,51,2011,3,8.9981
308,253,55,16,30.34,51,2011,3,12.998
628,567,61,17,29.52,54,2011,3,16.9979
531,462,69,18,29.52,54,2011,3,15.0013
443,364,79,19,28.7,58,2011,3,11.0014
280,247,33,20,27.06,61,2011,3,15.0013
177,160,17,21,27.06,57,2011,3,12.998
179,145,34,22,27.06,57,2011,3,15.0013
126,111,15,23,26.24,65,2011,3,16.9979
64,58,6,0,26.24,65,2011,3,12.998
32,28,4,1,25.42,73,2011,3,7.0015
20,11,9,2,25.42,73,2011,3,7.0015
8,4,4,3,24.6,83,2011,3,11.0014
4,2,2,4,24.6,83,2011,3,6.0032
20,20,0,5,24.6,83,2011,3,8.9981
76,73,3,6,24.6,83,2011,3,8.9981
259,253,6,7,24.6,83,2011,3,7.0015
456,434,22,8,25.42,78,2011,3,12.998
220,190,30,9,25.42,83,2011,3,7.0015
140,106,34,10,26.24,76,2011,3,11.0014
192,141,51,11,27.06,74,2011,3,7.0015
260,178,82,12,27.06,69,2011,3,15.0013
279,207,72,13,27.88,65,2011,3,8.9981
283,208,75,14,28.7,61,2011,3,7.0015
346,277,69,15,28.7,61,2011,3,16.9979
381,299,82,16,28.7,61,2011,3,8.9981
455,377,78,17,27.88,65,2011,3,11.0014
355,305,50,18,27.88,65,2011,3,12.998
287,220,67,19,27.06,69,2011,3,8.9981
196,158,38,20,26.24,73,2011,3,11.9084984
149,121,28,21,26.24,73,2011,3,6.0032
147,114,33,22,26.24,73,2011,3,11.0014
98,68,30,23,26.24,73,2011,3,11.0014
87,65,22,0,26.24,73,2011,3,7.0015
74,57,17,1,26.24,69,2011,3,16.9979
41,26,15,2,26.24,69,2011,3,15.0013
35,18,17,3,25.42,73,2011,3,11.0014
7,4,3,4,25.42,73,2011,3,11.0014
12,9,3,5,25.42,69,2011,3,12.998
23,19,4,6,25.42,73,2011,3,11.0014
38,33,5,7,25.42,73,2011,3,12.998
89,65,24,8,26.24,69,2011,3,11.0014
201,118,83,9,27.06,69,2011,3,16.9979
258,168,90,10,27.06,65,2011,3,16.9979
194,128,66,11,27.06,69,2011,3,19.0012
257,160,97,12,28.7,61,2011,3,15.0013
353,200,153,13,28.7,65,2011,3,15.0013
380,176,204,14,29.52,66,2011,3,11.0014
388,201,187,15,29.52,70,2011,3,11.0014
374,188,186,16,29.52,70,2011,3,12.998
371,201,170,17,29.52,70,2011,3,15.0013
339,179,160,18,29.52,70,2011,3,11.0014
295,148,147,19,28.7,74,2011,3,8.9981
219,120,99,20,28.7,79,2011,3,11.0014
164,93,71,21,27.88,83,2011,3,8.9981
162,96,66,22,27.88,83,2011,3,7.0015
123,77,46,23,27.06,85,2011,3,8.9981
109,76,33,0,27.06,89,2011,3,12.998
75,38,37,1,27.06,83,2011,3,8.9981
60,43,17,2,27.06,83,2011,3,12.998
43,23,20,3,26.24,89,2011,3,12.998
4,4,0,4,26.24,83,2011,3,11.0014
6,5,1,5,26.24,83,2011,3,8.9981
3,3,0,6,26.24,84,2011,3,15.0013
30,20,10,7,27.06,78,2011,3,12.998
70,49,21,8,27.06,78,2011,3,11.0014
189,102,87,9,27.06,78,2011,3,11.0014
297,147,150,10,28.7,74,2011,3,8.9981
337,163,174,11,30.34,70,2011,3,11.0014
435,221,214,12,31.16,66,2011,3,11.0014
419,174,245,13,31.98,62,2011,3,19.0012
361,156,205,14,31.98,66,2011,3,22.0028
410,192,218,15,31.98,66,2011,3,19.0012
337,141,196,16,32.8,59,2011,3,15.0013
376,172,204,17,31.16,66,2011,3,15.0013
356,169,187,18,31.16,66,2011,3,12.998
328,150,178,19,30.34,70,2011,3,12.998
229,125,104,20,30.34,70,2011,3,19.9995
207,103,104,21,29.52,74,2011,3,16.9979
155,85,70,22,29.52,74,2011,3,19.0012
104,58,46,23,29.52,70,2011,3,11.0014
97,66,31,0,28.7,74,2011,3,15.0013
54,35,19,1,27.88,79,2011,3,7.0015
39,22,17,2,27.88,79,2011,3,11.0014
16,12,4,3,27.88,74,2011,3,19.9995
8,5,3,4,27.88,69,2011,3,19.0012
6,4,2,5,27.06,74,2011,3,11.0014
11,5,6,6,27.06,74,2011,3,8.9981
41,30,11,7,27.06,74,2011,3,11.0014
101,56,45,8,27.06,78,2011,3,12.998
152,89,63,9,27.88,74,2011,3,11.0014
244,137,107,10,28.7,70,2011,3,11.0014
308,207,101,11,28.7,74,2011,3,11.0014
353,212,141,12,29.52,70,2011,3,12.998
389,235,154,13,30.34,70,2011,3,8.9981
357,212,145,14,30.34,70,2011,3,11.0014
253,142,111,15,27.88,79,2011,3,19.0012
284,192,92,16,27.88,79,2011,3,19.0012
114,77,37,17,27.06,89,2011,3,7.0015
123,92,31,18,27.06,89,2011,3,6.0032
175,123,52,19,27.06,94,2011,3,7.0015
82,56,26,20,27.06,94,2011,3,16.9979
60,40,20,21,27.06,94,2011,3,19.9995
64,49,15,22,24.6,88,2011,3,39.0007
20,17,3,23,22.96,88,2011,3,26.0027
8,7,1,0,22.14,94,2011,3,23.9994
2,2,0,2,22.14,94,2011,3,16.9979
1,0,1,3,22.14,94,2011,3,19.9995
4,3,1,4,22.14,94,2011,3,19.9995
21,20,1,5,22.14,88,2011,3,23.9994
72,72,0,6,22.14,88,2011,3,22.0028
172,166,6,7,22.14,83,2011,3,23.9994
364,349,15,8,22.14,83,2011,3,26.0027
185,167,18,9,22.14,81,2011,3,27.9993
106,90,16,10,22.14,83,2011,3,23.9994
89,78,11,11,22.14,83,2011,3,26.0027
67,51,16,12,22.14,83,2011,3,26.0027
29,24,5,13,22.14,88,2011,3,19.9995
24,21,3,14,22.14,88,2011,3,19.0012
89,71,18,15,22.14,94,2011,3,26.0027
106,95,11,16,22.14,94,2011,3,26.0027
291,276,15,17,22.14,88,2011,3,26.0027
373,351,22,18,22.14,88,2011,3,26.0027
281,269,12,19,22.14,88,2011,3,27.9993
163,150,13,20,22.14,88,2011,3,19.9995
121,109,12,21,22.14,88,2011,3,19.0012
84,79,5,22,22.14,94,2011,3,22.0028
58,56,2,23,22.14,94,2011,3,16.9979
13,12,1,0,22.14,94,2011,3,15.0013
5,3,2,1,22.14,94,2011,3,16.9979
6,4,2,2,22.14,94,2011,3,15.0013
2,1,1,3,22.96,94,2011,3,8.9981
4,4,0,4,22.96,94,2011,3,11.0014
16,15,1,5,22.96,100,2011,3,8.9981
75,74,1,6,24.6,88,2011,3,7.0015
86,83,3,7,24.6,88,2011,3,6.0032
328,319,9,8,25.42,94,2011,3,6.0032
190,176,14,9,24.6,88,2011,3,8.9981
66,63,3,10,24.6,88,2011,3,8.9981
10,9,1,11,24.6,94,2011,3,12.8019473
22,21,1,12,22.96,94,2011,3,11.49998624
11,9,2,13,24.6,88,2011,3,15.57243844
25,24,1,14,24.6,93,2011,3,13.70038279
58,55,3,15,25.42,94,2011,3,7.0015
144,137,7,16,26.24,89,2011,3,10.1562211
285,264,21,17,26.24,89,2011,3,17.23605709
237,219,18,18,26.24,89,2011,3,17.23605709
226,212,14,19,26.24,89,2011,3,10.9830202
96,93,3,20,26.24,89,2011,3,6.0032
38,34,4,21,26.24,89,2011,3,6.0032
29,26,3,22,25.42,94,2011,3,11.0014
24,21,3,23,25.42,94,2011,3,12.998
14,11,3,0,24.6,100,2011,3,12.998
4,4,0,1,25.42,94,2011,3,7.0015
2,2,0,3,25.42,94,2011,3,9.668455304
3,3,0,4,25.42,94,2011,3,6.0032
14,13,1,5,25.42,94,2011,3,6.0032
56,55,1,6,25.42,94,2011,3,11.0014
179,172,7,7,25.42,94,2011,3,7.0015
195,188,7,8,25.42,94,2011,3,8.9981
69,65,4,9,25.42,100,2011,3,16.9979
65,57,8,10,26.24,94,2011,3,7.0015
98,82,16,11,26.24,94,2011,3,15.0013
102,85,17,12,27.06,94,2011,3,15.0013
126,112,14,13,27.88,83,2011,3,26.0027
120,105,15,14,28.7,79,2011,3,23.9994
139,115,24,15,27.06,89,2011,3,19.9995
156,151,5,16,26.24,94,2011,3,19.0012
113,102,11,17,26.24,94,2011,3,19.0012
68,66,2,18,26.24,94,2011,3,23.9994
52,51,1,19,25.42,100,2011,3,22.0028
89,83,6,20,25.42,94,2011,3,11.0014
82,76,6,21,26.24,94,2011,3,7.0015
70,65,5,22,25.42,100,2011,3,6.0032
26,26,0,23,25.42,100,2011,3,6.0032
16,15,1,0,26.24,94,2011,3,12.998
8,8,0,1,25.42,100,2011,3,11.0014
8,7,1,2,25.42,100,2011,3,16.9979
2,1,1,3,25.42,94,2011,3,16.9979
3,3,0,4,25.42,94,2011,3,11.0014
14,14,0,5,25.42,94,2011,3,8.9981
57,54,3,6,25.42,100,2011,3,8.9981
108,104,4,7,25.42,100,2011,3,16.9979
288,276,12,8,25.42,94,2011,3,11.0014
136,131,5,9,25.42,94,2011,3,11.0014
29,27,2,10,25.42,100,2011,3,10.42822458
72,66,6,11,25.42,94,2011,3,10.42603807
75,71,4,12,26.24,94,2011,3,9.19686459
122,108,14,13,28.7,79,2011,3,6.0032
148,119,29,14,29.52,74,2011,3,6.0032
188,161,27,15,30.34,66,2011,3,13.213539
285,244,41,16,30.34,66,2011,3,8.9981
505,451,54,17,28.7,79,2011,3,16.9979
410,377,33,18,28.7,79,2011,3,12.998
349,316,33,19,27.06,89,2011,3,11.0014
210,180,30,20,26.24,94,2011,3,6.0032
203,154,49,21,27.06,89,2011,3,10.27336336
160,127,33,22,25.42,94,2011,3,9.135328963
148,113,35,23,25.42,94,2011,3,6.0032
116,84,32,0,25.42,94,2011,3,9.135328963
83,67,16,1,25.42,94,2011,3,10.42603807
64,46,18,2,24.6,97,2011,3,7.0015
37,29,8,3,23.78,100,2011,3,8.9981
7,4,3,4,23.78,94,2011,3,6.0032
8,6,2,5,23.78,94,2011,3,8.9981
6,6,0,6,23.78,94,2011,3,11.0014
52,43,9,7,24.6,88,2011,3,8.9981
119,103,16,8,25.42,83,2011,3,11.0014
207,168,39,9,26.24,78,2011,3,19.9995
318,233,85,10,28.7,65,2011,3,16.9979
360,252,108,11,29.52,62,2011,3,16.9979
404,260,144,12,29.52,62,2011,3,15.0013
370,239,131,13,30.34,55,2011,3,19.0012
359,230,129,14,30.34,55,2011,3,19.0012
480,263,217,15,30.34,55,2011,3,15.0013
431,261,170,16,30.34,55,2011,3,12.998
460,275,185,17,30.34,55,2011,3,15.0013
360,241,119,18,29.52,58,2011,3,12.998
315,214,101,19,28.7,58,2011,3,8.9981
245,167,78,20,27.06,69,2011,3,7.0015
230,171,59,21,26.24,78,2011,3,6.0032
175,126,49,22,26.24,78,2011,3,10.8114281
139,107,32,23,25.42,88,2011,3,11.49594046
108,79,29,0,25.42,88,2011,3,10.03406706
88,66,22,1,25.42,88,2011,3,11.49594046
76,60,16,2,25.42,78,2011,3,12.998
45,30,15,3,25.42,78,2011,3,6.0032
9,6,3,4,24.6,83,2011,3,8.9981
39,24,15,5,24.6,83,2011,3,8.9981
20,16,4,6,23.78,88,2011,3,7.0015
37,28,9,7,24.6,88,2011,3,10.0069646
94,69,25,8,26.24,78,2011,3,10.8114281
227,168,59,9,27.06,74,2011,3,12.10994864
334,214,120,10,28.7,65,2011,3,12.88211613
402,258,144,11,28.7,65,2011,3,12.88211613
411,298,113,12,28.7,65,2011,3,12.88211613
350,231,119,13,30.34,58,2011,3,7.0015
342,222,120,14,29.52,58,2011,3,19.0012
404,270,134,15,30.34,51,2011,3,19.9995
483,303,180,16,29.52,51,2011,3,19.9995
380,228,152,17,29.52,51,2011,3,8.9981
339,229,110,18,27.88,65,2011,3,19.9995
333,232,101,19,26.24,69,2011,3,7.0015
226,161,65,20,25.42,73,2011,3,7.0015
159,114,45,21,26.24,69,2011,3,12.28157666
95,74,21,22,25.42,69,2011,3,26.0027
45,33,12,23,23.78,78,2011,3,6.0032
16,11,5,0,22.96,88,2011,3,6.0032
12,11,1,1,22.96,88,2011,3,10.10366203
2,0,2,2,22.96,88,2011,3,10.10366203
4,4,0,4,22.14,94,2011,3,7.0015
24,23,1,5,22.96,83,2011,3,10.57081239
109,108,1,6,22.96,83,2011,3,10.57081239
312,300,12,7,23.78,83,2011,3,10.54267716
408,382,26,8,24.6,78,2011,3,6.0032
176,155,21,9,26.24,69,2011,3,12.28157666
129,89,40,10,27.88,62,2011,3,11.0014
165,131,34,11,28.7,58,2011,3,12.998
184,147,37,12,29.52,51,2011,3,12.998
163,120,43,13,29.52,54,2011,3,7.0015
189,129,60,14,30.34,51,2011,3,11.0014
212,152,60,15,30.34,48,2011,3,6.0032
298,238,60,16,29.52,48,2011,3,13.87065723
590,515,75,17,29.52,51,2011,3,11.0014
571,515,56,18,28.7,54,2011,3,12.998
436,373,63,19,27.88,57,2011,3,8.9981
299,258,41,20,27.06,65,2011,3,12.73171373
195,166,29,21,26.24,73,2011,3,6.0032
150,134,16,22,25.42,83,2011,3,11.0014
69,62,7,23,25.42,83,2011,3,7.0015
26,19,7,0,24.6,88,2011,3,7.0015
10,6,4,1,23.78,83,2011,3,7.0015
2,0,2,2,24.6,78,2011,3,10.63816323
4,2,2,3,23.78,83,2011,3,10.54267716
8,6,2,4,22.96,88,2011,3,10.10366203
20,19,1,5,22.96,88,2011,3,10.10366203
122,116,6,6,22.96,88,2011,3,7.0015
362,348,14,7,23.78,83,2011,3,6.0032
425,399,26,8,24.6,81,2011,3,7.0015
214,179,35,9,26.24,69,2011,3,6.0032
135,93,42,10,27.88,69,2011,3,8.9981
153,120,33,11,28.7,61,2011,3,11.0014
187,144,43,12,29.52,58,2011,3,15.0013
184,136,48,13,30.34,51,2011,3,19.0012
190,139,51,14,30.34,51,2011,3,22.0028
180,145,35,15,30.34,51,2011,3,19.9995
292,251,41,16,30.34,51,2011,3,15.0013
579,507,72,17,30.34,51,2011,3,15.0013
539,472,67,18,28.7,61,2011,3,11.0014
396,341,55,19,27.88,69,2011,3,11.0014
272,241,31,20,27.06,74,2011,3,12.998
245,200,45,21,26.24,78,2011,3,11.0014
144,120,24,22,26.24,78,2011,3,8.9981
74,59,15,23,26.24,78,2011,3,7.0015
33,28,5,0,25.42,78,2011,3,6.0032
8,7,1,1,25.42,78,2011,3,6.0032
5,4,1,2,24.6,83,2011,3,10.42323938
8,7,1,3,24.6,88,2011,3,8.9981
9,8,1,4,24.6,83,2011,3,6.0032
31,30,1,5,23.78,88,2011,3,7.0015
145,138,7,6,23.78,88,2011,3,7.0015
370,350,20,7,24.6,83,2011,3,7.0015
429,396,33,8,25.42,83,2011,3,11.0014
202,183,19,9,26.24,78,2011,3,11.0014
142,115,27,10,28.7,70,2011,3,8.9981
164,121,43,11,29.52,66,2011,3,11.0014
212,156,56,12,30.34,58,2011,3,15.0013
178,139,39,13,31.16,55,2011,3,16.9979
124,105,19,14,31.98,52,2011,3,15.0013
176,146,30,15,31.98,49,2011,3,16.9979
277,241,36,16,31.16,52,2011,3,19.0012
599,512,87,17,31.16,52,2011,3,19.0012
586,503,83,18,29.52,62,2011,3,11.0014
381,337,44,19,28.7,70,2011,3,7.0015
261,221,40,20,29.52,58,2011,3,27.9993
213,189,24,21,27.06,65,2011,3,15.0013
160,140,20,22,27.06,65,2011,3,8.9981
72,62,10,23,26.24,69,2011,3,7.0015
37,34,3,0,26.24,69,2011,3,8.9981
20,20,0,1,26.24,69,2011,3,11.0014
5,5,0,2,25.42,73,2011,3,7.0015
8,5,3,3,25.42,73,2011,3,6.0032
7,5,2,4,24.6,78,2011,3,7.0015
31,30,1,5,24.6,78,2011,3,10.63816323
124,119,5,6,24.6,83,2011,3,16.9979
338,321,17,7,25.42,78,2011,3,12.998
391,364,27,8,26.24,73,2011,3,8.9981
209,186,23,9,26.24,73,2011,3,23.9994
121,96,25,10,27.06,69,2011,3,16.9979
159,120,39,11,27.88,65,2011,3,8.9981
179,148,31,12,27.06,69,2011,3,19.9995
189,151,38,13,26.24,65,2011,3,19.0012
170,134,36,14,26.24,65,2011,3,27.9993
135,110,25,15,24.6,69,2011,3,27.9993
222,193,29,16,22.14,77,2011,3,31.0009
261,230,31,17,19.68,82,2011,3,31.0009
244,222,22,18,19.68,67,2011,3,40.9973
232,212,20,19,18.86,67,2011,3,31.0009
248,223,25,20,18.86,63,2011,3,22.0028
145,134,11,21,18.86,63,2011,3,22.0028
115,108,7,22,18.04,67,2011,3,19.0012
69,61,8,23,18.04,67,2011,3,15.0013
48,43,5,0,17.22,71,2011,3,15.0013
26,19,7,1,17.22,67,2011,3,12.998
10,7,3,2,16.4,71,2011,3,19.0012
6,4,2,3,16.4,71,2011,3,16.9979
4,3,1,4,16.4,71,2011,3,19.0012
32,30,2,5,15.58,76,2011,3,12.998
93,87,6,6,15.58,71,2011,3,15.0013
299,283,16,7,16.4,71,2011,3,19.0012
409,386,23,8,17.22,67,2011,3,15.0013
210,189,21,9,18.86,55,2011,3,16.9979
140,104,36,10,20.5,51,2011,3,19.0012
179,139,40,11,20.5,51,2011,3,8.9981
251,212,39,12,21.32,45,2011,3,15.89062088
223,168,55,13,22.14,42,2011,3,15.92891336
225,176,49,14,22.14,45,2011,3,11.0014
203,165,38,15,22.14,45,2011,3,15.0013
358,291,67,16,21.32,48,2011,3,11.0014
566,480,86,17,21.32,48,2011,3,8.9981
482,427,55,18,21.32,52,2011,3,11.0014
315,256,59,19,20.5,55,2011,3,11.0014
225,184,41,20,20.5,55,2011,3,14.64790539
163,124,39,21,20.5,63,2011,3,14.20334831
167,135,32,22,19.68,67,2011,3,6.0032
126,106,20,23,20.5,59,2011,3,14.30037467
108,80,28,0,18.86,72,2011,3,11.0014
80,52,28,1,18.86,72,2011,3,7.0015
79,61,18,2,18.86,82,2011,3,6.0032
28,21,7,3,18.86,72,2011,3,8.9981
5,4,1,4,18.86,72,2011,3,8.9981
5,3,2,5,18.86,72,2011,3,11.0014
22,17,5,6,18.86,72,2011,3,15.0013
37,33,4,7,18.86,77,2011,3,12.998
108,81,27,8,18.86,77,2011,3,16.9979
177,145,32,9,19.68,67,2011,3,15.0013
249,177,72,10,20.5,68,2011,3,19.0012
367,248,119,11,21.32,68,2011,3,15.0013
372,257,115,12,21.32,67,2011,3,15.0013
349,225,124,13,21.32,68,2011,3,12.998
297,174,123,14,21.32,72,2011,3,12.998
354,206,148,15,21.32,72,2011,3,12.998
305,189,116,16,22.14,68,2011,3,16.9979
359,218,141,17,21.32,72,2011,3,15.0013
329,234,95,18,21.32,72,2011,3,15.0013
256,186,70,19,21.32,68,2011,3,8.9981
176,133,43,20,21.32,68,2011,3,8.9981
170,121,49,21,20.5,72,2011,3,12.998
143,112,31,22,20.5,72,2011,3,15.0013
136,100,36,23,18.86,82,2011,3,11.0014
112,88,24,0,18.86,77,2011,3,15.0013
79,66,13,1,18.86,77,2011,3,15.0013
89,68,21,2,18.04,82,2011,3,16.9979
36,25,11,3,18.04,82,2011,3,12.998
1,0,1,4,18.04,77,2011,3,15.0013
6,5,1,5,18.04,77,2011,3,15.0013
12,10,2,6,18.04,77,2011,3,16.9979
44,29,15,7,18.86,72,2011,3,15.0013
69,53,16,8,18.86,72,2011,3,16.9979
140,94,46,9,19.68,67,2011,3,16.9979
260,178,82,10,20.5,72,2011,3,11.0014
317,201,116,11,21.32,68,2011,3,15.0013
364,229,135,12,22.14,64,2011,3,8.9981
376,214,162,13,22.96,60,2011,3,8.9981
311,184,127,14,23.78,56,2011,3,8.9981
365,233,132,15,23.78,60,2011,3,8.9981
369,235,134,16,22.96,64,2011,3,11.0014
325,230,95,17,22.96,64,2011,3,12.998
289,223,66,18,22.96,60,2011,3,7.0015
245,191,54,19,22.14,68,2011,3,7.0015
180,136,44,20,22.14,68,2011,3,6.0032
147,110,37,21,22.14,68,2011,3,6.0032
84,75,9,22,22.14,68,2011,3,6.0032
54,44,10,23,22.14,68,2011,3,12.998
37,23,14,0,21.32,72,2011,3,11.0014
10,7,3,1,21.32,72,2011,3,7.0015
13,7,6,2,21.32,72,2011,3,8.9981
5,4,1,3,20.5,77,2011,3,8.9981
8,6,2,4,20.5,77,2011,3,11.0014
28,26,2,5,20.5,77,2011,3,12.998
113,107,6,6,20.5,77,2011,3,15.0013
332,312,20,7,20.5,82,2011,3,15.0013
420,391,29,8,21.32,77,2011,3,8.9981
215,183,32,9,22.14,68,2011,3,11.0014
105,84,21,10,22.96,64,2011,3,8.9981
139,98,41,11,23.78,64,2011,3,11.0014
189,138,51,12,23.78,60,2011,3,6.0032
177,124,53,13,24.6,60,2011,3,13.80224074
188,143,45,14,24.6,60,2011,3,12.998
187,143,44,15,24.6,60,2011,3,15.0013
263,208,55,16,24.6,60,2011,3,11.0014
568,483,85,17,23.78,64,2011,3,8.9981
540,484,56,18,22.96,68,2011,3,8.9981
374,333,41,19,22.96,68,2011,3,7.0015
231,204,27,20,22.96,68,2011,3,8.9981
200,181,19,21,22.96,68,2011,3,11.0014
129,104,25,22,22.96,68,2011,3,11.0014
68,55,13,23,22.96,73,2011,3,12.998
130,106,24,0,20.5,63,2011,4,26.0027
58,47,11,1,19.68,67,2011,4,22.0028
67,46,21,2,18.86,63,2011,4,27.9993
25,17,8,3,18.86,59,2011,4,27.9993
8,6,2,4,18.04,58,2011,4,27.9993
5,4,1,5,18.04,62,2011,4,19.9995
19,15,4,6,17.22,67,2011,4,22.0028
36,30,6,7,17.22,67,2011,4,16.9979
67,58,9,8,16.4,76,2011,4,22.0028
129,112,17,9,16.4,82,2011,4,23.9994
121,100,21,10,16.4,76,2011,4,23.9994
132,102,30,11,15.58,82,2011,4,22.0028
158,130,28,12,16.4,82,2011,4,16.9979
125,98,27,13,16.4,82,2011,4,22.0028
180,147,33,14,17.22,71,2011,4,23.9994
195,154,41,15,17.22,71,2011,4,19.0012
223,165,58,16,16.4,76,2011,4,19.9995
228,170,58,17,16.4,76,2011,4,12.998
140,117,23,18,15.58,87,2011,4,15.0013
126,99,27,19,15.58,82,2011,4,12.998
66,58,8,20,14.76,87,2011,4,7.0015
56,53,3,21,14.76,87,2011,4,7.0015
70,58,12,22,14.76,93,2011,4,15.0013
65,57,8,23,14.76,93,2011,4,15.0013
47,43,4,0,14.76,93,2011,4,19.9995
24,23,1,1,13.94,87,2011,4,16.9979
30,27,3,2,13.94,87,2011,4,19.9995
9,5,4,3,13.94,87,2011,4,19.0012
7,3,4,4,13.94,87,2011,4,16.9979
7,7,0,5,13.12,87,2011,4,19.0012
15,13,2,6,13.12,81,2011,4,11.0014
29,24,5,7,13.94,76,2011,4,12.998
64,50,14,8,13.94,76,2011,4,12.998
115,96,19,9,14.76,76,2011,4,23.9994
248,188,60,10,14.76,71,2011,4,19.0012
292,218,74,11,15.58,66,2011,4,16.9979
321,243,78,12,16.4,62,2011,4,12.998
308,224,84,13,16.4,62,2011,4,15.0013
256,195,61,14,14.76,81,2011,4,11.0014
173,144,29,15,14.76,81,2011,4,16.9979
206,162,44,16,14.76,87,2011,4,12.998
167,135,32,17,14.76,87,2011,4,11.0014
174,158,16,18,14.76,81,2011,4,12.998
162,128,34,19,15.58,76,2011,4,11.0014
87,71,16,20,14.76,76,2011,4,16.9979
88,71,17,21,14.76,71,2011,4,15.0013
64,55,9,22,14.76,81,2011,4,6.0032
25,19,6,23,14.76,81,2011,4,6.0032
16,13,3,0,13.94,87,2011,4,7.0015
6,5,1,1,14.76,81,2011,4,6.0032
4,4,0,2,14.76,76,2011,4,7.0015
7,6,1,3,14.76,81,2011,4,9.632118998
8,6,2,4,13.94,87,2011,4,7.0015
21,17,4,5,14.76,76,2011,4,7.0015
94,91,3,6,14.76,71,2011,4,12.99771209
249,241,8,7,14.76,71,2011,4,8.9981
372,359,13,8,14.76,71,2011,4,7.0015
153,141,12,9,16.4,66,2011,4,6.0032
101,82,19,10,16.4,66,2011,4,7.0015
126,100,26,11,16.4,71,2011,4,15.0013
147,118,29,12,16.4,71,2011,4,8.9981
118,102,16,13,17.22,67,2011,4,11.0014
120,94,26,14,16.4,76,2011,4,16.83416295
101,79,22,15,16.4,76,2011,4,16.83416295
218,202,16,16,16.4,76,2011,4,7.0015
495,455,40,17,16.4,76,2011,4,11.0014
412,384,28,18,16.4,76,2011,4,11.0014
315,300,15,19,16.4,76,2011,4,10.28126146
204,191,13,20,16.4,82,2011,4,17.43622014
138,128,10,21,16.4,82,2011,4,12.47613402
91,79,12,22,16.4,82,2011,4,12.47613402
54,43,11,23,16.4,82,2011,4,7.0015
27,22,5,0,16.4,87,2011,4,6.0032
9,8,1,1,16.4,87,2011,4,7.0015
3,2,1,2,16.4,87,2011,4,11.97487149
6,3,3,3,16.4,82,2011,4,7.0015
7,4,3,4,16.4,82,2011,4,6.0032
27,25,2,5,16.4,82,2011,4,8.9981
112,109,3,6,16.4,82,2011,4,7.0015
309,298,11,7,17.22,82,2011,4,19.0012
400,372,28,8,18.04,77,2011,4,15.0013
187,168,19,9,18.86,67,2011,4,16.9979
126,107,19,10,19.68,67,2011,4,19.0012
124,102,22,11,22.14,64,2011,4,19.0012
199,160,39,12,22.96,56,2011,4,19.9995
173,153,20,13,22.96,56,2011,4,19.9995
183,156,27,14,23.78,53,2011,4,16.9979
194,166,28,15,23.78,56,2011,4,19.0012
309,273,36,16,23.78,56,2011,4,22.0028
585,530,55,17,22.96,60,2011,4,26.0027
524,456,68,18,22.14,64,2011,4,19.0012
345,310,35,19,21.32,68,2011,4,15.0013
261,236,25,20,21.32,68,2011,4,15.0013
166,144,22,21,20.5,72,2011,4,8.9981
114,106,8,22,20.5,72,2011,4,8.9981
66,60,6,23,19.68,77,2011,4,8.9981
43,36,7,0,19.68,77,2011,4,8.9981
11,7,4,1,19.68,77,2011,4,11.0014
3,2,1,2,18.86,82,2011,4,11.0014
6,5,1,3,18.86,82,2011,4,7.0015
5,4,1,4,18.04,88,2011,4,10.64139606
32,29,3,5,18.04,82,2011,4,8.9981
117,112,5,6,18.04,82,2011,4,7.0015
301,292,9,7,18.86,77,2011,4,7.0015
467,441,26,8,21.32,63,2011,4,14.18884967
219,187,32,9,22.14,60,2011,4,19.9995
133,103,30,10,22.96,56,2011,4,26.0027
170,138,32,11,24.6,46,2011,4,19.0012
214,180,34,12,25.42,43,2011,4,22.0028
219,189,30,13,26.24,41,2011,4,15.0013
190,156,34,14,26.24,41,2011,4,19.0012
182,147,35,15,26.24,47,2011,4,19.0012
282,245,37,16,26.24,47,2011,4,22.0028
591,525,66,17,26.24,47,2011,4,16.9979
593,536,57,18,24.6,53,2011,4,11.0014
374,334,40,19,23.78,56,2011,4,8.9981
246,228,18,20,21.32,77,2011,4,11.0014
201,173,28,21,20.5,82,2011,4,7.0015
154,134,20,22,21.32,72,2011,4,12.1102009
73,64,9,23,20.5,77,2011,4,7.0015
40,34,6,0,20.5,72,2011,4,12.998
22,17,5,1,19.68,63,2011,4,12.998
10,8,2,2,18.86,67,2011,4,12.998
5,4,1,3,18.04,67,2011,4,15.0013
5,5,0,4,18.04,62,2011,4,19.0012
24,24,0,5,17.22,62,2011,4,12.998
114,110,4,6,16.4,66,2011,4,12.998
302,287,15,7,17.22,62,2011,4,12.998
457,437,20,8,18.04,62,2011,4,11.0014
208,188,20,9,18.86,63,2011,4,12.998
129,105,24,10,21.32,52,2011,4,15.89644516
144,115,29,11,22.14,49,2011,4,16.17027488
226,180,46,12,22.96,49,2011,4,6.0032
191,158,33,13,22.96,46,2011,4,6.0032
195,139,56,14,23.78,43,2011,4,6.0032
219,157,62,15,23.78,46,2011,4,8.9981
323,272,51,16,23.78,49,2011,4,12.998
568,505,63,17,22.96,52,2011,4,8.9981
538,479,59,18,22.14,64,2011,4,6.0032
343,305,38,19,21.32,59,2011,4,7.0015
260,231,29,20,20.5,77,2011,4,7.0015
195,161,34,21,18.86,88,2011,4,6.0032
148,124,24,22,18.86,82,2011,4,10.84465561
99,81,18,23,18.04,88,2011,4,6.0032
67,48,19,0,18.04,88,2011,4,10.64139606
28,25,3,1,18.04,88,2011,4,10.64139606
5,5,0,2,17.22,88,2011,4,10.0550977
10,9,1,3,16.4,87,2011,4,9.517502419
5,5,0,4,16.4,87,2011,4,7.0015
27,24,3,5,17.22,82,2011,4,10.54737372
87,84,3,6,17.22,88,2011,4,10.0550977
242,237,5,7,17.22,94,2011,4,8.825455097
417,386,31,8,18.86,82,2011,4,10.84465561
241,207,34,9,19.68,77,2011,4,11.02830404
174,126,48,10,21.32,68,2011,4,6.0032
230,150,80,11,22.96,63,2011,4,14.10823656
235,174,61,12,24.6,53,2011,4,15.24311692
305,210,95,13,24.6,46,2011,4,15.74726887
256,179,77,14,25.42,50,2011,4,15.30875207
270,202,68,15,27.06,41,2011,4,15.7168234
419,346,73,16,26.24,44,2011,4,14.73829535
563,462,101,17,24.6,56,2011,4,16.9979
465,371,94,18,22.96,60,2011,4,6.0032
294,243,51,19,22.96,52,2011,4,15.87815824
197,167,30,20,22.14,49,2011,4,16.17027488
166,144,22,21,20.5,68,2011,4,12.49285854
146,119,27,22,20.5,68,2011,4,12.49285854
136,113,23,23,20.5,63,2011,4,14.22795264
89,72,17,0,19.68,72,2011,4,12.19912063
65,51,14,1,18.86,82,2011,4,10.84465561
45,41,4,2,18.86,82,2011,4,10.84465561
20,16,4,3,18.04,88,2011,4,10.64139606
10,7,3,4,17.22,94,2011,4,8.9981
8,7,1,5,17.22,88,2011,4,7.0015
22,16,6,6,17.22,94,2011,4,8.825455097
73,46,27,7,17.22,94,2011,4,6.0032
103,89,14,8,18.86,82,2011,4,10.84465561
217,163,54,9,20.5,77,2011,4,11.25024909
337,217,120,10,21.32,77,2011,4,11.35413763
397,221,176,11,23.78,56,2011,4,14.73657133
446,255,191,12,25.42,35,2011,4,16.99200283
485,229,256,13,25.42,46,2011,4,7.0015
465,214,251,14,25.42,50,2011,4,6.0032
496,234,262,15,27.06,39,2011,4,16.36777109
451,230,221,16,26.24,44,2011,4,6.0032
393,219,174,17,25.42,50,2011,4,8.9981
359,224,135,18,24.6,46,2011,4,7.0015
248,172,76,19,22.14,68,2011,4,8.9981
202,124,78,20,21.32,77,2011,4,7.0015
187,133,54,21,21.32,77,2011,4,11.35413763
149,104,45,22,20.5,77,2011,4,11.25024909
142,90,52,23,19.68,88,2011,4,10.91441177
129,83,46,0,18.86,88,2011,4,6.0032
78,63,15,1,18.86,88,2011,4,10.59734686
55,35,20,2,18.86,88,2011,4,10.59734686
30,20,10,3,18.04,88,2011,4,10.64139606
14,7,7,4,18.04,88,2011,4,10.64139606
15,14,1,5,18.04,88,2011,4,10.64139606
21,14,7,6,18.04,88,2011,4,10.64139606
44,26,18,7,18.04,86,2011,4,10.57648591
107,82,25,8,18.86,88,2011,4,10.59734686
185,119,66,9,20.5,77,2011,4,11.25024909
365,210,155,10,22.96,68,2011,4,6.0032
423,234,189,11,25.42,53,2011,4,6.0032
455,243,212,12,26.24,44,2011,4,6.0032
418,193,225,13,27.06,44,2011,4,6.0032
500,228,272,14,27.88,47,2011,4,11.0014
407,209,198,15,27.88,51,2011,4,11.0014
470,247,223,16,27.06,50,2011,4,8.9981
438,230,208,17,25.42,61,2011,4,7.0015
414,228,186,18,26.24,50,2011,4,7.0015
302,186,116,19,22.96,73,2011,4,6.0032
193,134,59,20,22.96,73,2011,4,7.0015
173,120,53,21,22.14,83,2011,4,7.0015
152,104,48,22,21.32,94,2011,4,11.18579064
123,85,38,23,20.5,88,2011,4,7.0015
53,42,11,0,20.5,94,2011,4,9.913529416
34,30,4,1,19.68,88,2011,4,10.91441177
19,15,4,2,19.68,88,2011,4,10.91441177
11,9,2,3,18.86,88,2011,4,10.59734686
6,4,2,4,18.86,94,2011,4,9.184905082
21,19,2,5,18.86,94,2011,4,9.184905082
44,39,5,6,18.04,94,2011,4,9.172640624
114,102,12,7,18.86,88,2011,4,10.59734686
254,227,27,8,21.32,83,2011,4,11.53443825
219,161,58,9,22.14,77,2011,4,11.85475702
265,158,107,10,22.96,73,2011,4,11.0014
322,183,139,11,25.42,69,2011,4,6.0032
365,201,164,12,28.7,48,2011,4,6.0032
365,219,146,13,29.52,37,2011,4,13.79512017
370,223,147,14,30.34,37,2011,4,13.9426259
384,254,130,15,29.52,42,2011,4,7.0015
402,248,154,16,28.7,45,2011,4,6.0032
459,334,125,17,27.06,54,2011,4,7.0015
473,365,108,18,26.24,53,2011,4,14.21327231
336,267,69,19,23.78,78,2011,4,6.0032
225,188,37,20,24.6,73,2011,4,12.16671166
175,148,27,21,22.96,88,2011,4,6.0032
126,104,22,22,22.96,88,2011,4,6.0032
75,63,12,23,22.14,88,2011,4,7.0015
30,16,14,0,22.14,88,2011,4,13.34675866
11,9,2,1,21.32,94,2011,4,6.0032
5,4,1,2,21.32,94,2011,4,8.9981
3,1,2,3,21.32,88,2011,4,7.0015
5,5,0,4,21.32,88,2011,4,8.9981
20,20,0,5,21.32,88,2011,4,12.08252856
123,114,9,6,21.32,83,2011,4,6.0032
352,333,19,7,21.32,88,2011,4,6.0032
406,375,31,8,22.96,83,2011,4,7.0015
235,195,40,9,24.6,69,2011,4,13.40112325
149,111,38,10,24.6,69,2011,4,8.9981
123,92,31,11,24.6,73,2011,4,11.0014
181,130,51,12,24.6,73,2011,4,11.0014
180,138,42,13,24.6,73,2011,4,12.998
171,117,54,14,24.6,73,2011,4,7.0015
175,139,36,15,24.6,78,2011,4,11.0014
320,257,63,16,24.6,73,2011,4,11.0014
604,534,70,17,24.6,78,2011,4,16.9979
539,493,46,18,24.6,78,2011,4,15.0013
318,285,33,19,23.78,83,2011,4,15.0013
234,203,31,20,23.78,83,2011,4,15.0013
175,158,17,21,23.78,78,2011,4,12.998
147,120,27,22,22.96,83,2011,4,12.998
57,47,10,23,22.96,83,2011,4,19.0012
25,23,2,0,22.96,83,2011,4,8.9981
10,8,2,1,22.96,83,2011,4,8.9981
2,2,0,2,22.96,83,2011,4,19.0012
2,2,0,3,22.14,94,2011,4,19.9995
7,6,1,4,22.14,94,2011,4,26.0027
22,22,0,5,22.14,88,2011,4,22.0028
112,107,5,6,22.14,88,2011,4,16.9979
259,244,15,7,22.14,88,2011,4,26.0027
404,377,27,8,22.14,88,2011,4,26.0027
197,183,14,9,22.14,88,2011,4,30.0026
113,98,15,10,22.14,88,2011,4,26.0027
120,102,18,11,22.14,94,2011,4,22.0028
62,53,9,12,22.14,88,2011,4,22.0028
101,76,25,13,22.14,88,2011,4,15.0013
78,70,8,14,22.14,94,2011,4,19.0012
45,42,3,15,22.14,94,2011,4,16.9979
55,50,5,16,22.96,88,2011,4,15.0013
251,235,16,17,22.14,94,2011,4,15.0013
172,161,11,18,22.14,94,2011,4,8.9981
109,102,7,19,22.14,94,2011,4,8.9981
90,81,9,20,22.14,94,2011,4,7.0015
83,74,9,21,22.14,100,2011,4,7.0015
43,40,3,22,22.14,94,2011,4,6.0032
54,41,13,23,22.14,94,2011,4,6.0032
15,14,1,0,22.14,94,2011,4,8.9981
12,9,3,1,22.14,94,2011,4,11.82071386
4,4,0,2,22.14,94,2011,4,11.82071386
6,4,2,3,22.14,100,2011,4,12.998
7,5,2,4,22.14,100,2011,4,7.0015
17,16,1,5,22.14,100,2011,4,7.0015
52,51,1,6,22.14,100,2011,4,6.0032
81,76,5,7,22.14,100,2011,4,8.9981
209,199,10,8,22.14,100,2011,4,6.0032
109,106,3,9,22.96,100,2011,4,7.0015
69,53,16,10,22.96,100,2011,4,8.9981
84,76,8,11,25.42,83,2011,4,12.1354736
105,95,10,12,25.42,88,2011,4,11.75265066
162,142,20,13,26.24,83,2011,4,11.0014
133,111,22,14,27.06,78,2011,4,12.998
155,128,27,15,27.06,78,2011,4,12.998
276,240,36,16,27.06,74,2011,4,15.0013
479,432,47,17,25.42,83,2011,4,16.9979
268,248,20,18,25.42,83,2011,4,16.9979
205,187,18,19,25.42,83,2011,4,11.0014
181,166,15,20,25.42,83,2011,4,19.0012
123,115,8,21,25.42,83,2011,4,12.998
114,101,13,22,25.42,83,2011,4,12.998
47,45,2,23,23.78,88,2011,4,12.998
39,29,10,0,23.78,94,2011,4,6.0032
24,16,8,1,23.78,94,2011,4,8.9981
6,6,0,2,22.96,94,2011,4,11.0014
7,6,1,3,22.96,94,2011,4,8.9981
8,8,0,4,22.96,94,2011,4,12.998
17,17,0,5,22.96,94,2011,4,11.0014
94,90,4,6,22.96,88,2011,4,12.998
147,137,10,7,22.96,88,2011,4,12.998
209,186,23,8,22.96,90,2011,4,11.0014
180,164,16,9,22.96,94,2011,4,15.0013
125,108,17,10,22.14,88,2011,4,23.9994
87,76,11,11,21.32,88,2011,4,11.0014
75,62,13,12,21.32,88,2011,4,11.0014
132,114,18,13,22.96,73,2011,4,23.9994
156,119,37,14,25.42,43,2011,4,23.9994
230,169,61,15,25.42,43,2011,4,19.0012
344,264,80,16,24.6,43,2011,4,15.0013
481,426,55,17,23.78,46,2011,4,27.9993
423,361,62,18,22.14,39,2011,4,19.0012
248,221,27,19,22.14,39,2011,4,22.0028
196,177,19,20,21.32,42,2011,4,12.998
178,156,22,21,20.5,45,2011,4,12.998
143,123,20,22,18.86,59,2011,4,15.0013
95,80,15,23,18.86,59,2011,4,11.0014
106,88,18,0,18.86,55,2011,4,7.0015
73,64,9,1,18.86,55,2011,4,16.9979
56,39,17,2,18.86,59,2011,4,12.998
23,18,5,3,18.04,62,2011,4,12.998
6,6,0,4,17.22,67,2011,4,8.9981
7,6,1,5,17.22,71,2011,4,11.0014
20,15,5,6,16.4,71,2011,4,12.06983704
57,40,17,7,16.4,76,2011,4,7.0015
125,101,24,8,18.86,59,2011,4,19.0012
207,157,50,9,21.32,48,2011,4,19.9995
322,207,115,10,22.14,45,2011,4,30.0026
374,221,153,11,22.96,40,2011,4,26.0027
456,261,195,12,23.78,35,2011,4,36.9974
394,223,171,13,24.6,35,2011,4,31.0009
472,230,242,14,24.6,33,2011,4,31.0009
377,211,166,15,25.42,31,2011,4,32.9975
443,264,179,16,25.42,29,2011,4,26.0027
441,264,177,17,23.78,32,2011,4,19.0012
372,251,121,18,22.14,39,2011,4,12.998
238,177,61,19,20.5,51,2011,4,8.9981
179,137,42,20,20.5,48,2011,4,8.9981
168,115,53,21,20.5,42,2011,4,15.0013
166,121,45,22,20.5,36,2011,4,8.9981
135,102,33,23,19.68,41,2011,4,11.0014
107,85,22,0,18.86,44,2011,4,8.9981
77,64,13,1,18.04,47,2011,4,8.9981
65,52,13,2,17.22,54,2011,4,8.9981
42,31,11,3,17.22,54,2011,4,8.9981
12,7,5,4,17.22,54,2011,4,12.998
7,6,1,5,17.22,54,2011,4,11.0014
10,7,3,6,15.58,66,2011,4,11.0014
48,39,9,7,16.4,62,2011,4,8.9981
99,71,28,8,18.04,62,2011,4,12.998
190,151,39,9,20.5,45,2011,4,15.0013
347,226,121,10,22.14,45,2011,4,16.9979
377,218,159,11,22.96,35,2011,4,19.0012
444,277,167,12,23.78,35,2011,4,16.9979
438,269,169,13,24.6,35,2011,4,19.9995
462,258,204,14,24.6,40,2011,4,19.9995
412,230,182,15,25.42,35,2011,4,26.0027
466,289,177,16,24.6,46,2011,4,26.0027
405,253,152,17,23.78,49,2011,4,31.0009
328,226,102,18,22.96,49,2011,4,30.0026
233,181,52,19,22.14,52,2011,4,26.0027
178,129,49,20,22.14,52,2011,4,31.0009
102,88,14,21,22.14,52,2011,4,26.0027
130,88,42,22,22.96,49,2011,4,27.9993
62,48,14,23,22.96,52,2011,4,27.9993
37,25,12,0,22.14,56,2011,4,22.0028
17,15,2,1,22.96,54,2011,4,26.0027
7,3,4,2,22.96,54,2011,4,26.0027
2,2,0,3,22.96,49,2011,4,12.998
5,3,2,4,21.32,59,2011,4,11.0014
29,28,1,5,20.5,63,2011,4,19.9995
114,107,7,6,20.5,55,2011,4,16.9979
309,299,10,7,20.5,55,2011,4,11.0014
414,381,33,8,20.5,51,2011,4,16.9979
206,180,26,9,20.5,45,2011,4,19.0012
135,92,43,10,21.32,45,2011,4,11.0014
166,131,35,11,22.96,43,2011,4,15.94943118
205,166,39,12,22.96,40,2011,4,6.0032
205,156,49,13,22.96,46,2011,4,6.0032
166,122,44,14,23.78,49,2011,4,12.998
208,142,66,15,22.96,60,2011,4,16.9979
302,238,64,16,23.78,56,2011,4,16.9979
620,540,80,17,22.96,64,2011,4,8.9981
518,469,49,18,22.96,60,2011,4,14.05028869
333,288,45,19,22.14,68,2011,4,7.0015
229,189,40,20,21.32,77,2011,4,7.0015
177,141,36,21,20.5,77,2011,4,7.0015
104,88,16,22,20.5,77,2011,4,11.25024909
62,52,10,23,19.68,88,2011,4,12.01246447
31,23,8,0,19.68,82,2011,4,11.17572507
11,7,4,1,18.86,88,2011,4,11.96846179
5,4,1,2,18.04,94,2011,4,6.0032
1,1,0,3,18.04,94,2011,4,6.0032
4,4,0,4,18.04,94,2011,4,7.0015
21,19,2,5,18.86,88,2011,4,11.96846179
109,105,4,6,18.86,82,2011,4,6.0032
341,326,15,7,18.86,88,2011,4,6.0032
499,474,25,8,20.5,77,2011,4,6.0032
227,198,29,9,21.32,77,2011,4,6.0032
102,75,27,10,22.96,68,2011,4,13.33104797
147,112,35,11,24.6,49,2011,4,7.0015
201,159,42,12,25.42,43,2011,4,6.0032
219,171,48,13,26.24,38,2011,4,12.998
169,137,32,14,25.42,41,2011,4,11.0014
205,139,66,15,25.42,50,2011,4,12.998
304,246,58,16,25.42,57,2011,4,16.9979
625,553,72,17,24.6,60,2011,4,8.9981
570,512,58,18,22.96,68,2011,4,7.0015
317,286,31,19,22.96,60,2011,4,7.0015
227,204,23,20,22.14,64,2011,4,11.0014
206,178,28,21,22.14,68,2011,4,8.9981
137,115,22,22,21.32,77,2011,4,11.0014
70,63,7,23,21.32,77,2011,4,12.998
34,23,11,0,21.32,77,2011,4,12.998
16,9,7,1,21.32,77,2011,4,12.998
7,6,1,2,21.32,77,2011,4,12.998
3,3,0,4,20.5,94,2011,4,12.998
3,3,0,5,20.5,100,2011,4,7.0015
31,28,3,6,21.32,83,2011,4,16.9979
68,67,1,7,21.32,77,2011,4,16.9979
210,200,10,8,22.14,70,2011,4,32.9975
202,185,17,9,21.32,88,2011,4,32.9975
123,109,14,10,21.32,88,2011,4,32.9975
149,116,33,11,21.32,94,2011,4,16.9979
130,117,13,12,21.32,94,2011,4,22.0028
106,86,20,13,22.14,94,2011,4,19.0012
97,80,17,14,22.14,94,2011,4,11.0014
120,99,21,15,22.14,100,2011,4,8.9981
201,180,21,16,22.96,94,2011,4,11.0014
181,170,11,17,22.96,94,2011,4,11.0014
140,132,8,18,22.96,100,2011,4,11.0014
197,189,8,19,24.6,88,2011,4,8.9981
145,140,5,20,24.6,94,2011,4,6.0032
85,79,6,21,23.78,94,2011,4,8.9981
107,94,13,22,23.78,94,2011,4,23.9994
69,55,14,23,23.78,94,2011,4,23.9994
21,18,3,0,14.76,87,2011,4,11.0014
11,8,3,1,14.76,81,2011,4,8.9981
4,3,1,2,14.76,81,2011,4,11.0014
6,5,1,3,14.76,81,2011,4,8.9981
8,7,1,4,13.94,81,2011,4,15.0013
18,18,0,5,13.12,81,2011,4,12.998
93,90,3,6,13.12,81,2011,4,12.998
254,246,8,7,13.94,76,2011,4,12.998
419,402,17,8,14.76,71,2011,4,16.9979
222,206,16,9,16.4,66,2011,4,11.0014
135,114,21,10,18.04,62,2011,4,8.9981
117,101,16,11,18.86,63,2011,4,7.0015
176,153,23,12,20.5,48,2011,4,6.0032
167,147,20,13,19.68,55,2011,4,12.998
150,118,32,14,20.5,48,2011,4,16.9979
186,148,38,15,20.5,45,2011,4,8.9981
298,252,46,16,19.68,44,2011,4,11.0014
506,470,36,17,18.04,54,2011,4,11.0014
460,421,39,18,17.22,58,2011,4,7.0015
313,274,39,19,17.22,58,2011,4,6.0032
209,191,18,20,16.4,71,2011,4,12.02745559
127,114,13,21,14.76,81,2011,4,9.731371489
96,91,5,22,14.76,81,2011,4,9.731371489
72,61,11,23,13.94,87,2011,4,7.711642334
19,19,0,0,13.12,87,2011,4,7.974812837
10,8,2,1,12.3,87,2011,4,8.131835574
2,2,0,2,12.3,87,2011,4,8.131835574
2,2,0,3,12.3,75,2011,4,8.711105548
4,4,0,4,12.3,87,2011,4,8.131835574
27,27,0,5,12.3,81,2011,4,8.553909896
92,91,1,6,12.3,81,2011,4,8.553909896
251,240,11,7,12.3,81,2011,4,8.553909896
472,452,20,8,13.12,87,2011,4,7.974812837
228,213,15,9,13.94,87,2011,4,7.711642334
133,108,25,10,16.4,71,2011,4,6.0032
144,117,27,11,17.22,71,2011,4,8.9981
189,157,32,12,18.86,55,2011,4,11.0014
161,139,22,13,19.68,48,2011,4,11.0014
172,132,40,14,20.5,45,2011,4,11.0014
187,161,26,15,19.68,51,2011,4,11.0014
266,231,35,16,19.68,51,2011,4,7.0015
553,523,30,17,18.04,62,2011,4,12.998
479,448,31,18,17.22,71,2011,4,11.0014
282,257,25,19,16.4,76,2011,4,8.9981
182,177,5,20,16.4,66,2011,4,8.9981
168,155,13,21,15.58,71,2011,4,8.9981
106,99,7,22,14.76,71,2011,4,8.9981
57,54,3,23,14.76,76,2011,4,6.0032
31,28,3,0,14.76,76,2011,4,6.0032
15,12,3,1,13.94,81,2011,4,8.9981
7,5,2,2,13.94,76,2011,4,8.9981
5,4,1,3,13.94,81,2011,4,8.9981
4,3,1,4,13.12,81,2011,4,6.0032
28,27,1,5,13.12,81,2011,4,8.9981
99,96,3,6,13.94,76,2011,4,12.998
292,280,12,7,13.12,81,2011,4,6.0032
402,394,8,8,13.94,81,2011,4,6.0032
164,155,9,9,14.76,81,2011,4,12.998
110,98,12,10,16.4,76,2011,4,12.998
120,108,12,11,18.04,67,2011,4,12.998
179,162,17,12,20.5,51,2011,4,12.998
169,150,19,13,21.32,48,2011,4,16.9979
152,120,32,14,21.32,52,2011,4,11.0014
162,138,24,15,21.32,52,2011,4,11.0014
267,234,33,16,21.32,48,2011,4,12.998
498,465,33,17,19.68,55,2011,4,6.0032
433,409,24,18,18.86,63,2011,4,8.9981
252,234,18,19,18.04,67,2011,4,6.0032
209,198,11,20,17.22,71,2011,4,7.0015
144,140,4,21,16.4,76,2011,4,8.9981
137,116,21,22,16.4,82,2011,4,10.0636606
95,80,15,23,16.4,82,2011,4,6.0032
43,32,11,0,16.4,82,2011,4,12.74331957
17,16,1,1,16.4,82,2011,4,12.74331957
10,8,2,2,16.4,76,2011,4,12.64127806
8,7,1,3,15.58,87,2011,4,11.0014
7,6,1,4,15.58,87,2011,4,6.0032
23,23,0,5,15.58,87,2011,4,10.97661873
66,64,2,6,15.58,87,2011,4,6.0032
245,235,10,7,16.4,86,2011,4,15.0013
395,387,8,8,16.4,87,2011,4,23.9994
254,239,15,9,17.22,71,2011,4,31.0009
134,115,19,10,17.22,71,2011,4,22.0028
162,128,34,11,18.04,67,2011,4,30.0026
197,153,44,12,19.68,55,2011,4,32.9975
194,161,33,13,18.04,51,2011,4,27.9993
201,147,54,14,18.04,47,2011,4,19.9995
237,192,45,15,18.86,44,2011,4,26.0027
290,237,53,16,18.86,36,2011,4,26.0027
480,438,42,17,17.22,38,2011,4,23.9994
374,339,35,18,17.22,32,2011,4,31.0009
196,182,14,19,16.4,37,2011,4,23.9994
186,171,15,20,14.76,43,2011,4,19.0012
123,115,8,21,13.94,46,2011,4,16.9979
115,109,6,22,13.94,46,2011,4,22.0028
89,72,17,23,13.12,49,2011,4,22.0028
52,48,4,0,13.12,45,2011,4,23.9994
62,57,5,1,13.12,45,2011,4,19.9995
31,24,7,2,12.3,52,2011,4,22.0028
8,8,0,3,12.3,52,2011,4,19.9995
8,5,3,4,11.48,56,2011,4,22.0028
2,2,0,5,10.66,60,2011,4,22.0028
23,20,3,6,10.66,60,2011,4,16.9979
34,31,3,7,10.66,60,2011,4,19.0012
84,80,4,8,11.48,56,2011,4,22.0028
141,111,30,9,12.3,56,2011,4,19.9995
227,171,56,10,13.12,53,2011,4,16.9979
238,169,69,11,14.76,46,2011,4,7.0015
372,235,137,12,14.76,46,2011,4,11.0014
355,207,148,13,16.4,37,2011,4,7.0015
386,227,159,14,17.22,35,2011,4,8.9981
343,202,141,15,16.4,37,2011,4,12.998
335,207,128,16,16.4,40,2011,4,15.0013
334,234,100,17,15.58,40,2011,4,11.0014
237,185,52,18,14.76,50,2011,4,6.0032
204,159,45,19,13.94,53,2011,4,8.291302367
165,136,29,20,13.12,66,2011,4,10.19314787
118,99,19,21,13.12,66,2011,4,10.19314787
82,72,10,22,12.3,65,2011,4,9.860572053
85,81,4,23,11.48,70,2011,4,9.739255505
75,65,10,0,11.48,75,2011,4,8.394830894
115,104,11,1,10.66,81,2011,4,8.097809221
29,23,6,2,10.66,81,2011,4,8.097809221
9,4,5,3,9.84,87,2011,4,7.500577855
6,6,0,4,9.84,87,2011,4,7.500577855
5,5,0,5,9.84,87,2011,4,8.9981
16,11,5,6,10.66,81,2011,4,6.0032
28,24,4,7,10.66,87,2011,4,7.0015
90,71,19,8,11.48,87,2011,4,6.0032
170,134,36,9,12.3,75,2011,4,6.0032
262,186,76,10,14.76,66,2011,4,6.0032
320,216,104,11,17.22,58,2011,4,6.0032
346,226,120,12,18.04,54,2011,4,14.69191899
314,209,105,13,18.86,51,2011,4,11.0014
320,219,101,14,18.86,55,2011,4,12.998
306,210,96,15,19.68,51,2011,4,12.998
347,263,84,16,18.86,55,2011,4,15.0013
256,185,71,17,18.04,62,2011,4,11.0014
185,146,39,18,17.22,71,2011,4,7.0015
151,130,21,19,15.58,76,2011,4,12.998
116,100,16,20,14.76,81,2011,4,7.0015
88,77,11,21,14.76,81,2011,4,6.0032
45,40,5,22,14.76,87,2011,4,9.375977942
50,43,7,23,13.94,87,2011,4,6.0032
15,14,1,0,13.94,87,2011,4,7.711642334
8,6,2,1,13.94,87,2011,4,7.711642334
2,2,0,2,13.12,93,2011,4,8.004298398
3,3,0,3,13.12,93,2011,4,8.004298398
6,4,2,4,13.12,93,2011,4,8.004298398
26,25,1,5,12.3,93,2011,4,8.104620954
99,97,2,6,11.48,93,2011,4,9.567973072
311,305,6,7,11.48,93,2011,4,9.567973072
410,397,13,8,12.3,100,2011,4,6.0032
174,156,18,9,13.94,100,2011,4,8.9981
123,95,28,10,14.76,93,2011,4,8.9981
128,100,28,11,17.22,77,2011,4,7.0015
179,158,21,12,18.86,67,2011,4,13.13710117
189,157,32,13,22.14,49,2011,4,6.0032
145,115,30,14,22.96,37,2011,4,11.0014
170,132,38,15,22.96,37,2011,4,7.0015
295,255,40,16,21.32,45,2011,4,15.84698914
528,489,39,17,20.5,45,2011,4,11.0014
425,407,18,18,18.86,59,2011,4,7.0015
300,280,20,19,18.86,59,2011,4,14.46699843
204,187,17,20,16.4,71,2011,4,12.02745559
139,129,10,21,15.58,82,2011,4,7.0015
108,102,6,22,14.76,81,2011,4,6.0032
48,47,1,23,14.76,87,2011,4,6.0032
18,18,0,0,13.94,87,2011,4,6.0032
11,8,3,1,13.12,93,2011,4,7.0015
1,1,0,2,13.12,87,2011,4,7.974812837
3,3,0,3,13.12,87,2011,4,7.974812837
4,4,0,4,12.3,87,2011,4,8.131835574
18,17,1,5,12.3,87,2011,4,6.0032
99,96,3,6,12.3,87,2011,4,8.131835574
323,316,7,7,12.3,87,2011,4,7.0015
466,455,11,8,13.12,93,2011,4,7.0015
191,177,14,9,14.76,87,2011,4,9.375977942
129,104,25,10,17.22,71,2011,4,6.0032
147,126,21,11,18.86,63,2011,4,8.9981
203,175,28,12,21.32,52,2011,4,8.9981
196,165,31,13,22.14,49,2011,4,11.0014
161,129,32,14,22.96,46,2011,4,7.0015
188,155,33,15,23.78,46,2011,4,7.0015
289,250,39,16,22.96,46,2011,4,8.9981
499,459,40,17,21.32,43,2011,4,11.0014
462,432,30,18,19.68,55,2011,4,8.9981
278,264,14,19,18.86,59,2011,4,14.46699843
181,169,12,20,16.4,76,2011,4,10.27295698
182,166,16,21,16.4,76,2011,4,10.27295698
108,95,13,22,14.76,87,2011,4,9.375977942
48,45,3,23,14.76,81,2011,4,9.731371489
13,13,0,0,14.76,87,2011,4,9.375977942
10,10,0,1,13.94,87,2011,4,7.711642334
5,5,0,2,13.12,93,2011,4,8.004298398
4,4,0,3,13.12,93,2011,4,8.004298398
4,4,0,4,13.12,87,2011,4,7.974812837
28,28,0,5,12.3,87,2011,4,8.131835574
98,98,0,6,12.3,87,2011,4,8.131835574
300,300,0,7,12.3,87,2011,4,8.131835574
456,437,19,8,13.12,93,2011,4,8.004298398
219,197,22,9,13.94,93,2011,4,7.751549846
105,89,16,10,16.4,76,2011,4,7.0015
152,131,21,11,18.86,67,2011,4,11.0014
180,156,24,12,20.5,51,2011,4,11.0014
167,136,31,13,20.5,51,2011,4,11.0014
179,153,26,14,21.32,48,2011,4,11.0014
151,130,21,15,21.32,45,2011,4,15.0013
281,257,24,16,21.32,48,2011,4,12.998
485,458,27,17,18.86,63,2011,4,7.0015
408,387,21,18,18.04,67,2011,4,7.0015
304,292,12,19,18.04,72,2011,4,7.0015
219,201,18,20,18.04,77,2011,4,10.96217887
161,152,9,21,16.4,87,2011,4,9.706168383
114,105,9,22,16.4,87,2011,4,9.706168383
66,61,5,23,15.58,87,2011,4,9.785193262
24,24,0,0,16.4,87,2011,4,9.706168383
11,10,1,1,16.4,87,2011,4,12.44226355
5,5,0,2,15.58,94,2011,4,9.928298378
11,11,0,3,15.58,94,2011,4,6.0032
3,2,1,4,15.58,94,2011,4,6.0032
23,22,1,5,14.76,100,2011,4,8.9981
114,110,4,6,14.76,100,2011,4,8.9981
272,266,6,7,15.58,94,2011,4,11.0014
436,418,18,8,16.4,94,2011,4,6.0032
211,188,23,9,17.22,94,2011,4,7.0015
117,100,17,10,18.04,88,2011,4,15.0013
108,99,9,11,18.86,67,2011,4,26.0027
167,149,18,12,17.22,67,2011,4,23.9994
96,87,9,13,14.76,81,2011,4,23.9994
64,58,6,14,14.76,87,2011,4,19.0012
62,57,5,15,14.76,81,2011,4,19.9995
73,67,6,16,14.76,81,2011,4,15.0013
177,168,9,17,14.76,81,2011,4,15.0013
273,263,10,18,14.76,81,2011,4,11.0014
211,192,19,19,14.76,71,2011,4,15.0013
168,160,8,20,14.76,62,2011,4,19.0012
136,130,6,21,14.76,57,2011,4,16.9979
89,84,5,22,14.76,53,2011,4,19.0012
82,73,9,23,13.94,57,2011,4,11.0014
66,56,10,0,13.94,53,2011,4,16.9979
19,16,3,1,13.12,57,2011,4,22.0028
11,10,1,2,13.12,57,2011,4,19.0012
6,6,0,3,12.3,61,2011,4,12.998
8,8,0,4,12.3,61,2011,4,12.998
13,13,0,5,12.3,49,2011,4,16.9979
46,46,0,6,11.48,45,2011,4,22.0028
121,116,5,7,11.48,45,2011,4,16.9979
258,249,9,8,12.3,42,2011,4,23.9994
201,186,15,9,13.12,45,2011,4,30.0026
200,162,38,10,13.12,42,2011,4,36.9974
170,150,20,11,13.94,42,2011,4,32.9975
239,198,41,12,13.94,42,2011,4,31.0009
236,179,57,13,15.58,37,2011,4,36.9974
247,183,64,14,15.58,37,2011,4,31.0009
216,187,29,15,14.76,37,2011,4,27.9993
238,189,49,16,14.76,34,2011,4,22.0028
310,286,24,17,13.94,39,2011,4,22.0028
208,185,23,18,13.94,39,2011,4,16.9979
199,182,17,19,13.12,39,2011,4,11.0014
109,97,12,20,13.12,39,2011,4,12.998
83,79,4,21,12.3,45,2011,4,11.0014
91,78,13,22,13.12,39,2011,4,12.998
73,67,6,23,12.3,45,2011,4,6.0032
64,52,12,0,9.84,60,2011,4,8.9981
54,45,9,1,9.84,60,2011,4,8.9981
46,39,7,2,9.84,65,2011,4,6.0032
17,13,4,3,9.84,70,2011,4,8.9981
7,7,0,4,8.2,80,2011,4,8.9981
4,3,1,5,9.02,75,2011,4,6.0032
7,7,0,6,9.02,75,2011,4,11.0014
27,24,3,7,9.02,75,2011,4,12.998
101,87,14,8,10.66,70,2011,4,12.998
160,142,18,9,12.3,61,2011,4,11.0014
232,170,62,10,13.94,61,2011,4,19.0012
315,213,102,11,15.58,54,2011,4,19.0012
366,224,142,12,18.04,44,2011,4,19.0012
353,225,128,13,19.68,36,2011,4,19.0012
435,244,191,14,20.5,36,2011,4,19.9995
386,221,165,15,21.32,29,2011,4,19.0012
361,224,137,16,21.32,32,2011,4,16.9979
285,193,92,17,20.5,34,2011,4,16.9979
203,150,53,18,17.22,58,2011,4,12.998
171,139,32,19,17.22,50,2011,4,16.9979
132,101,31,20,17.22,50,2011,4,19.0012
122,103,19,21,17.22,47,2011,4,19.0012
118,88,30,22,17.22,47,2011,4,16.9979
101,78,23,23,16.4,58,2011,4,11.0014
73,61,12,0,16.4,58,2011,4,12.998
71,58,13,1,14.76,66,2011,4,12.998
57,48,9,2,14.76,57,2011,4,7.0015
28,20,8,3,14.76,62,2011,4,8.9981
6,5,1,4,14.76,62,2011,4,8.9981
5,3,2,5,13.94,61,2011,4,11.0014
23,18,5,6,13.94,66,2011,4,8.9981
43,30,13,7,13.94,66,2011,4,15.0013
79,55,24,8,13.94,66,2011,4,6.0032
135,97,38,9,16.4,54,2011,4,19.0012
241,178,63,10,18.04,44,2011,4,22.0028
295,187,108,11,18.86,40,2011,4,27.9993
354,242,112,12,21.32,29,2011,4,27.9993
339,234,105,13,21.32,29,2011,4,27.9993
371,263,108,14,22.14,28,2011,4,32.9975
310,221,89,15,20.5,42,2011,4,22.0028
319,226,93,16,22.14,28,2011,4,26.0027
231,187,44,17,21.32,27,2011,4,22.0028
190,155,35,18,21.32,27,2011,4,22.0028
157,121,36,19,20.5,29,2011,4,23.9994
139,115,24,20,20.5,31,2011,4,23.9994
95,76,19,21,19.68,36,2011,4,16.9979
89,64,25,22,19.68,41,2011,4,26.0027
67,49,18,23,18.86,51,2011,4,19.9995
30,22,8,0,18.86,59,2011,4,19.0012
11,6,5,1,18.86,63,2011,4,19.9995
17,10,7,2,18.86,63,2011,4,23.9994
7,3,4,3,18.04,67,2011,4,19.0012
5,5,0,4,18.04,67,2011,4,15.0013
19,19,0,5,18.04,67,2011,4,16.9979
114,104,10,6,18.04,72,2011,4,15.0013
322,311,11,7,18.04,72,2011,4,16.9979
452,425,27,8,18.86,67,2011,4,12.998
233,204,29,9,19.68,67,2011,4,22.0028
111,85,26,10,20.5,63,2011,4,19.0012
128,106,22,11,22.14,60,2011,4,19.0012
202,166,36,12,22.96,56,2011,4,19.9995
203,153,50,13,24.6,49,2011,4,26.0027
185,138,47,14,25.42,46,2011,4,30.0026
195,142,53,15,26.24,44,2011,4,22.0028
315,264,51,16,25.42,46,2011,4,27.9993
519,464,55,17,25.42,46,2011,4,16.9979
489,460,29,18,22.96,56,2011,4,19.0012
302,274,28,19,24.6,53,2011,4,19.9995
240,210,30,20,24.6,53,2011,4,23.9994
213,176,37,21,24.6,53,2011,4,23.9994
113,96,17,22,23.78,56,2011,4,23.9994
61,48,13,23,22.96,64,2011,4,19.9995
22,15,7,0,22.96,64,2011,4,23.9994
10,5,5,1,22.96,60,2011,4,19.9995
15,8,7,2,22.96,64,2011,4,16.9979
4,4,0,3,22.14,68,2011,4,22.0028
7,6,1,4,22.96,64,2011,4,19.9995
28,26,2,5,22.14,68,2011,4,19.0012
108,104,4,6,22.96,64,2011,4,6.0032
319,298,21,7,22.14,68,2011,4,11.0014
480,453,27,8,22.14,68,2011,4,7.0015
200,174,26,9,22.96,64,2011,4,6.0032
138,115,23,10,22.96,64,2011,4,19.0012
134,116,18,11,22.96,64,2011,4,12.998
176,148,28,12,22.14,68,2011,4,13.43490928
153,132,21,13,22.14,60,2011,4,15.0013
147,120,27,14,22.14,60,2011,4,19.0012
191,155,36,15,22.14,60,2011,4,8.9981
271,240,31,16,21.32,68,2011,4,8.9981
451,422,29,17,20.5,72,2011,4,12.998
441,414,27,18,20.5,72,2011,4,19.0012
286,259,27,19,20.5,72,2011,4,23.9994
238,212,26,20,19.68,82,2011,4,8.9981
168,145,23,21,20.5,77,2011,4,6.0032
128,109,19,22,18.86,88,2011,4,7.0015
80,66,14,23,18.86,94,2011,4,7.0015
31,26,5,0,18.86,94,2011,4,11.49747768
5,5,0,1,18.86,94,2011,4,6.0032
10,6,4,2,18.86,94,2011,4,7.0015
5,3,2,3,18.86,94,2011,4,7.0015
4,3,1,4,18.04,100,2011,4,15.0013
13,13,0,5,18.86,94,2011,4,7.0015
56,52,4,6,18.86,94,2011,4,6.0032
137,130,7,7,18.86,94,2011,4,11.93222546
232,223,9,8,18.86,94,2011,4,11.93222546
82,77,5,9,18.86,94,2011,4,11.93222546
36,32,4,10,18.86,94,2011,4,11.93222546
60,53,7,11,18.86,94,2011,4,6.0032
54,49,5,12,18.86,100,2011,4,10.13073223
58,52,6,13,18.86,94,2011,4,8.9981
61,49,12,14,18.86,100,2011,4,8.9981
66,50,16,15,19.68,94,2011,4,7.0015
123,110,13,16,19.68,94,2011,4,7.0015
233,216,17,17,19.68,88,2011,4,12.998
189,176,13,18,18.86,88,2011,4,26.0027
111,108,3,19,18.86,88,2011,4,26.0027
99,94,5,20,18.04,88,2011,4,26.0027
75,72,3,21,18.04,88,2011,4,19.0012
46,45,1,22,17.22,88,2011,4,15.0013
31,28,3,23,17.22,88,2011,4,8.9981
24,22,2,0,17.22,88,2011,4,16.9979
5,5,0,1,17.22,82,2011,4,11.0014
5,5,0,2,17.22,82,2011,4,15.0013
3,3,0,3,17.22,77,2011,4,22.0028
4,3,1,4,16.4,62,2011,4,27.9993
22,21,1,5,13.94,71,2011,4,22.0028
75,72,3,6,14.76,57,2011,4,15.0013
168,164,4,7,13.94,61,2011,4,19.0012
355,343,12,8,13.94,61,2011,4,19.9995
198,184,14,9,13.94,61,2011,4,22.0028
81,74,7,10,13.94,61,2011,4,22.0028
97,93,4,11,13.12,66,2011,4,22.0028
121,115,6,12,13.94,53,2011,4,19.9995
124,109,15,13,13.94,49,2011,4,30.0026
110,105,5,14,13.94,49,2011,4,26.0027
116,106,10,15,13.94,49,2011,4,30.0026
195,187,8,16,13.12,39,2011,4,27.9993
399,379,20,17,13.12,42,2011,4,26.0027
307,298,9,18,13.12,39,2011,4,12.998
217,210,7,19,12.3,45,2011,4,15.0013
169,162,7,20,12.3,42,2011,4,19.0012
116,113,3,21,12.3,42,2011,4,16.9979
84,83,1,22,10.66,52,2011,4,16.9979
58,58,0,23,10.66,52,2011,4,15.0013
30,28,2,0,10.66,48,2011,4,11.0014
10,10,0,1,10.66,44,2011,4,22.0028
10,8,2,2,9.84,44,2011,4,15.0013
2,2,0,3,9.84,41,2011,4,19.0012
5,5,0,4,9.02,44,2011,4,11.0014
22,22,0,5,9.02,44,2011,4,8.9981
71,70,1,6,9.02,44,2011,4,6.0032
216,211,5,7,9.02,44,2011,4,11.0014
375,369,6,8,9.02,44,2011,4,12.998
213,207,6,9,10.66,41,2011,4,12.998
115,105,10,10,10.66,41,2011,4,19.0012
140,122,18,11,12.3,36,2011,4,8.9981
165,143,22,12,13.12,33,2011,4,9.120580214
177,146,31,13,13.94,31,2011,4,15.0013
154,123,31,14,13.94,31,2011,4,8.9981
178,151,27,15,13.94,29,2011,4,8.9981
209,190,19,16,13.94,29,2011,4,8.9981
378,361,17,17,13.12,31,2011,4,8.9981
328,312,16,18,12.3,36,2011,4,11.0014
190,183,7,19,11.48,41,2011,4,11.0014
137,129,8,20,11.48,48,2011,4,12.998
111,108,3,21,11.48,48,2011,4,11.0014
97,88,9,22,10.66,52,2011,4,7.0015
59,54,5,23,10.66,60,2011,4,8.9981
53,49,4,0,10.66,56,2011,4,12.998
35,34,1,1,10.66,52,2011,4,19.9995
46,34,12,2,9.84,56,2011,4,11.0014
15,11,4,3,10.66,48,2011,4,16.9979
8,4,4,4,10.66,48,2011,4,22.0028
2,2,0,5,9.84,56,2011,4,16.9979
12,10,2,6,9.84,60,2011,4,22.0028
41,38,3,7,9.84,60,2011,4,16.9979
92,80,12,8,10.66,56,2011,4,16.9979
142,130,12,9,11.48,52,2011,4,19.9995
200,165,35,10,13.12,45,2011,4,16.9979
233,183,50,11,14.76,40,2011,4,13.47541212
311,218,93,12,16.4,35,2011,4,19.0012
363,245,118,13,17.22,30,2011,4,19.0012
349,228,121,14,17.22,32,2011,4,19.9995
382,262,120,15,17.22,41,2011,4,12.998
287,188,99,16,17.22,38,2011,4,19.9995
232,171,61,17,16.4,40,2011,4,12.998
208,172,36,18,15.58,46,2011,4,8.9981
182,149,33,19,13.94,71,2011,4,8.9981
163,115,48,20,14.76,57,2011,4,7.0015
108,79,29,21,14.76,62,2011,4,12.998
106,80,26,22,15.58,62,2011,4,11.0014
93,73,20,23,15.58,62,2011,4,15.0013
20,19,1,0,11.48,52,2011,4,22.0028
10,9,1,1,10.66,60,2011,4,19.0012
9,8,1,2,10.66,56,2011,4,19.9995
7,6,1,3,10.66,56,2011,4,16.9979
1,1,0,4,10.66,56,2011,4,19.0012
24,23,1,5,10.66,56,2011,4,16.9979
97,92,5,6,9.84,65,2011,4,19.0012
276,265,11,7,9.84,65,2011,4,23.9994
477,462,15,8,10.66,60,2011,4,22.0028
224,215,9,9,12.3,52,2011,4,22.0028
93,86,7,10,13.12,53,2011,4,19.9995
102,95,7,11,13.94,49,2011,4,16.9979
148,139,9,12,14.76,46,2011,4,15.0013
154,137,17,13,16.4,40,2011,4,15.0013
150,130,20,14,16.4,40,2011,4,15.0013
154,144,10,15,16.4,40,2011,4,15.0013
201,192,9,16,16.4,40,2011,4,12.998
418,409,9,17,14.76,46,2011,4,8.9981
405,393,12,18,14.76,43,2011,4,7.0015
228,219,9,19,13.94,46,2011,4,7.0015
190,178,12,20,13.94,46,2011,4,7.0015
162,154,8,21,12.3,61,2011,4,7.0015
104,99,5,22,12.3,61,2011,4,10.02272287
73,70,3,23,10.66,70,2011,4,6.0032
38,32,6,0,10.66,70,2011,4,6.0032
15,14,1,1,9.84,75,2011,4,7.739902408
10,10,0,2,9.84,75,2011,4,7.739902408
1,1,0,3,9.02,80,2011,4,7.724001059
3,3,0,4,9.02,80,2011,4,7.724001059
23,23,0,5,9.02,80,2011,4,6.0032
87,84,3,6,9.02,80,2011,4,7.724001059
205,199,6,7,9.02,87,2011,4,6.0032
445,432,13,8,9.84,87,2011,4,7.498441808
246,234,12,9,11.48,81,2011,4,8.33648574
105,89,16,10,12.3,75,2011,4,15.0013
160,142,18,11,13.94,66,2011,4,11.0014
204,186,18,12,14.76,57,2011,4,8.9981
207,188,19,13,16.4,47,2011,4,8.9981
170,145,25,14,17.22,44,2011,4,7.0015
199,175,24,15,17.22,41,2011,4,6.0032
276,254,22,16,17.22,41,2011,4,6.0032
411,391,20,17,17.22,38,2011,4,17.12974777
372,362,10,18,16.4,50,2011,4,16.75008147
265,252,13,19,13.94,53,2011,4,16.9979
190,178,12,20,15.58,40,2011,4,19.0012
111,102,9,21,13.94,49,2011,4,12.998
102,95,7,22,13.12,53,2011,4,12.998
95,81,14,23,13.12,53,2011,4,19.0012
75,65,10,0,12.3,56,2011,4,16.9979
71,62,9,1,10.66,65,2011,4,12.998
50,41,9,2,10.66,65,2011,4,11.0014
9,5,4,3,9.84,70,2011,4,8.9981
8,7,1,4,9.02,75,2011,4,8.9981
6,6,0,5,9.84,70,2011,4,6.0032
11,10,1,6,9.84,65,2011,4,7.0015
26,24,2,7,9.02,75,2011,4,6.0032
63,62,1,8,9.84,75,2011,4,6.0032
124,99,25,9,10.66,70,2011,4,7.0015
195,173,22,10,13.12,61,2011,4,8.9981
275,227,48,11,13.12,57,2011,4,6.0032
358,280,78,12,14.76,50,2011,4,12.79503288
292,222,70,13,14.76,50,2011,4,6.0032
343,251,92,14,14.76,46,2011,4,12.9301571
337,237,100,15,15.58,46,2011,4,16.96197418
305,230,75,16,15.58,46,2011,4,16.96197418
232,186,46,17,14.76,62,2011,4,13.51494083
224,193,31,18,13.94,53,2011,4,8.9981
175,144,31,19,12.3,61,2011,4,6.0032
127,110,17,20,12.3,61,2011,4,6.0032
109,104,5,21,12.3,61,2011,4,6.0032
114,97,17,22,13.12,61,2011,4,6.0032
85,73,12,23,12.3,70,2011,4,8.9981
83,64,19,0,12.3,70,2011,4,7.0015
74,54,20,1,12.3,75,2011,4,6.0032
62,51,11,2,10.66,81,2011,4,8.097488228
41,34,7,3,11.48,75,2011,4,8.391438338
11,9,2,4,10.66,87,2011,4,7.74314885
4,2,2,5,10.66,81,2011,4,8.097488228
4,3,1,6,9.84,93,2011,4,7.52222641
26,23,3,7,10.66,87,2011,4,7.74314885
55,48,7,8,10.66,87,2011,4,7.74314885
126,114,12,9,12.3,81,2011,4,8.557582401
216,180,36,10,13.12,81,2011,4,8.9981
254,206,48,11,13.94,81,2011,4,11.0014
329,247,82,12,14.76,81,2011,4,11.0014
357,269,88,13,16.4,66,2011,4,15.0013
323,246,77,14,17.22,62,2011,4,8.9981
296,227,69,15,17.22,62,2011,4,12.998
330,266,64,16,17.22,58,2011,4,15.0013
245,207,38,17,15.58,76,2011,4,8.9981
171,161,10,18,15.58,71,2011,4,11.96792795
173,158,15,19,15.58,76,2011,4,10.45705951
124,116,8,20,14.76,76,2011,4,8.9981
72,65,7,21,14.76,81,2011,4,7.0015
64,59,5,22,13.94,87,2011,4,7.0015
45,42,3,23,13.94,87,2011,4,7.0015
24,21,3,0,13.12,87,2011,4,6.0032
12,10,2,1,13.12,87,2011,4,8.016586902
8,8,0,2,13.12,87,2011,4,8.016586902
2,2,0,3,13.12,87,2011,4,8.016586902
7,7,0,4,12.3,87,2011,4,7.0015
25,24,1,5,12.3,87,2011,4,7.0015
90,89,1,6,12.3,93,2011,4,6.0032
283,274,9,7,13.12,90,2011,4,7.996661318
404,392,12,8,13.12,93,2011,4,8.053208866
190,178,12,9,14.76,87,2011,4,6.0032
87,78,9,10,14.76,87,2011,4,6.0032
123,106,17,11,14.76,87,2011,4,6.0032
154,125,29,12,16.4,76,2011,4,7.0015
171,153,18,13,17.22,71,2011,4,6.0032
133,126,7,14,18.86,67,2011,4,13.4694494
148,132,16,15,18.86,72,2011,4,6.0032
248,238,10,16,20.5,63,2011,4,6.0032
446,430,16,17,17.22,77,2011,4,10.75115018
399,386,13,18,18.04,77,2011,4,10.93489234
308,295,13,19,18.86,77,2011,4,12.77357548
205,190,15,20,18.86,82,2011,4,7.0015
176,166,10,21,18.04,88,2011,4,6.0032
106,94,12,22,18.04,88,2011,4,8.9981
62,54,8,23,18.86,88,2011,4,8.9981
28,25,3,0,20.5,77,2011,4,19.9995
16,14,2,1,18.86,88,2011,4,19.9995
3,3,0,2,18.86,87,2011,4,12.998
3,3,0,3,18.86,87,2011,4,12.998
7,7,0,4,18.86,88,2011,4,15.0013
20,20,0,5,18.86,88,2011,4,15.0013
86,81,5,6,18.04,94,2011,4,19.0012
234,227,7,7,18.86,94,2011,4,12.998
414,401,13,8,18.86,94,2011,4,12.998
204,200,4,9,18.86,94,2011,4,15.0013
50,44,6,10,18.86,94,2011,4,19.0012
32,28,4,11,18.86,94,2011,4,16.9979
55,50,5,12,18.86,100,2011,4,15.0013
71,65,6,13,18.86,100,2011,4,12.998
75,69,6,14,19.68,100,2011,4,15.0013
45,43,2,15,20.5,100,2011,4,12.998
88,84,4,16,18.86,100,2011,4,16.9979
262,249,13,17,18.86,100,2011,4,15.0013
304,287,17,18,18.86,100,2011,4,19.0012
233,223,10,19,18.86,100,2011,4,19.9995
110,107,3,20,18.86,100,2011,4,19.9995
114,108,6,21,18.04,100,2011,4,12.998
87,82,5,22,18.86,100,2011,4,11.0014
53,48,5,23,18.86,100,2011,4,11.0014
33,30,3,0,18.04,100,2011,4,12.998
13,9,4,1,18.86,100,2011,4,16.9979
6,4,2,2,18.86,100,2011,4,15.0013
3,3,0,3,18.86,100,2011,4,15.0013
1,1,0,4,18.86,100,2011,4,11.0014
3,3,0,5,18.86,100,2011,4,11.0014
18,18,0,6,19.68,100,2011,4,27.9993
46,43,3,7,18.04,100,2011,4,7.0015
86,80,6,8,18.04,100,2011,4,13.79337569
64,64,0,9,18.04,100,2011,4,16.9979
33,32,1,10,18.04,100,2011,4,6.0032
50,47,3,11,18.04,100,2011,4,6.0032
33,29,4,12,18.04,100,2011,4,8.9981
33,28,5,13,18.04,100,2011,4,12.998
25,24,1,14,18.04,100,2011,4,12.998
30,25,5,15,17.22,94,2011,4,15.0013
31,28,3,16,17.22,94,2011,4,12.998
52,48,4,17,16.4,100,2011,4,22.0028
51,48,3,18,16.4,94,2011,4,19.9995
33,31,2,19,13.94,87,2011,4,43.0006
26,25,1,20,13.94,87,2011,4,43.0006
6,6,0,21,12.3,87,2011,4,35.0008
13,13,0,22,9.84,93,2011,4,30.0026
16,16,0,23,9.84,93,2011,4,26.0027
21,21,0,0,10.66,87,2011,4,19.9995
7,6,1,1,10.66,81,2011,4,23.9994
4,4,0,2,11.48,65,2011,4,15.0013
1,1,0,3,10.66,60,2011,4,19.9995
2,2,0,4,9.84,60,2011,4,31.0009
12,12,0,5,9.02,64,2011,4,15.0013
71,71,0,6,9.02,55,2011,4,19.0012
244,233,11,7,9.02,60,2011,4,15.0013
429,418,11,8,9.02,55,2011,4,19.0012
225,218,7,9,9.84,52,2011,4,26.0027
110,109,1,10,10.66,52,2011,4,22.0028
106,100,6,11,11.48,52,2011,4,16.9979
156,148,8,12,11.48,52,2011,4,22.0028
124,115,9,13,12.3,49,2011,4,23.9994
137,121,16,14,13.12,45,2011,4,16.9979
117,98,19,15,13.12,45,2011,4,8.9981
208,201,7,16,13.12,45,2011,4,12.998
331,321,10,17,12.3,49,2011,4,7.0015
318,306,12,18,11.48,52,2011,4,15.0013
232,220,12,19,10.66,56,2011,4,7.0015
175,170,5,20,10.66,60,2011,4,7.0015
139,135,4,21,11.48,61,2011,4,6.0032
92,84,8,22,10.66,65,2011,4,8.9981
61,58,3,23,9.84,70,2011,4,7.0015
34,26,8,0,9.84,65,2011,4,8.728123726
14,12,2,1,9.84,65,2011,4,8.728123726
12,10,2,2,9.84,70,2011,4,8.542300635
6,5,1,3,9.02,80,2011,4,7.724001059
2,1,1,4,9.02,80,2011,4,7.724001059
20,20,0,5,9.02,80,2011,4,7.724001059
63,62,1,6,9.02,80,2011,4,6.0032
199,195,4,7,9.02,75,2011,4,6.0032
385,378,7,8,9.84,81,2011,4,7.761124267
264,256,8,9,10.66,81,2011,4,6.0032
126,115,11,10,12.3,70,2011,4,11.0014
136,121,15,11,13.12,70,2011,4,16.9979
173,146,27,12,14.76,57,2011,4,19.9995
168,141,27,13,15.58,50,2011,4,12.998
187,163,24,14,15.58,46,2011,4,19.0012
189,160,29,15,15.58,46,2011,4,19.0012
250,226,24,16,14.76,62,2011,4,8.9981
362,352,10,17,13.94,66,2011,4,7.0015
318,308,10,18,13.94,61,2011,4,12.01282329
199,189,10,19,13.94,61,2011,4,12.01282329
150,140,10,20,12.3,81,2011,4,8.557582401
140,131,9,21,12.3,75,2011,4,8.703282252
129,114,15,22,11.48,87,2011,4,7.942230641
94,88,6,23,11.48,81,2011,4,8.33648574
77,66,11,0,10.66,81,2011,4,7.0015
66,55,11,1,10.66,70,2011,4,11.0014
60,48,12,2,11.48,61,2011,4,6.0032
25,20,5,3,11.48,61,2011,4,6.0032
3,3,0,4,10.66,65,2011,4,7.0015
6,6,0,5,10.66,60,2011,4,11.0014
11,10,1,6,9.84,65,2011,4,7.0015
11,11,0,7,9.84,65,2011,4,12.998
73,68,5,8,10.66,65,2011,4,8.9981
149,134,15,9,11.48,61,2011,4,19.0012
192,161,31,10,13.12,57,2011,4,16.9979
236,192,44,11,13.12,53,2011,4,27.9993
283,235,48,12,13.12,45,2011,4,27.9993
286,239,47,13,13.94,34,2011,4,27.9993
293,242,51,14,13.94,31,2011,4,22.0028
299,239,60,15,13.94,34,2011,4,23.9994
241,183,58,16,13.12,31,2011,4,26.0027
185,151,34,17,11.48,36,2011,4,22.0028
172,144,28,18,10.66,38,2011,4,15.0013
154,139,15,19,10.66,38,2011,4,19.0012
124,114,10,20,9.84,35,2011,4,15.0013
83,79,4,21,9.02,44,2011,4,15.0013
95,88,7,22,9.02,41,2011,4,8.9981
66,61,5,23,8.2,47,2011,4,11.0014
74,69,5,0,8.2,51,2011,4,15.0013
62,54,8,1,6.56,59,2011,4,15.0013
52,47,5,2,7.38,55,2011,4,16.9979
19,17,2,3,6.56,59,2011,4,8.9981
5,5,0,4,6.56,59,2011,4,11.0014
6,6,0,5,7.38,59,2011,4,7.0015
10,10,0,6,6.56,59,2011,4,7.646443021
31,30,1,7,7.38,55,2011,4,7.54365192
72,68,4,8,6.56,69,2011,4,7.971360628
107,88,19,9,8.2,59,2011,4,7.310820872
194,164,30,10,9.84,44,2011,4,9.294188708
197,166,31,11,10.66,35,2011,4,13.2038556
288,246,42,12,10.66,35,2011,4,13.2038556
268,224,44,13,12.3,31,2011,4,8.052234792
242,198,44,14,12.3,28,2011,4,13.29148545
266,219,47,15,12.3,26,2011,4,15.58048396
206,174,32,16,12.3,26,2011,4,15.58048396
163,150,13,17,11.48,30,2011,4,8.766639043
163,151,12,18,9.84,48,2011,4,12.998
105,98,7,19,9.02,55,2011,4,12.998
72,62,10,20,9.02,55,2011,4,7.0015
63,53,10,21,9.02,55,2011,4,7.338909593
43,36,7,22,9.02,55,2011,4,7.338909593
35,31,4,23,8.2,69,2011,4,7.65838142
20,16,4,0,8.2,69,2011,4,6.0032
9,9,0,1,8.2,69,2011,4,7.65838142
4,4,0,2,8.2,69,2011,4,7.65838142
2,2,0,3,7.38,74,2011,4,9.281924434
3,3,0,4,7.38,74,2011,4,9.281924434
21,21,0,5,6.56,80,2011,4,8.212968558
64,63,1,6,6.56,80,2011,4,7.0015
235,231,4,7,5.74,86,2011,4,8.9981
385,378,7,8,6.56,80,2011,4,7.0015
220,208,12,9,7.38,74,2011,4,6.0032
105,91,14,10,9.02,69,2011,4,7.0015
115,100,15,11,10.66,60,2011,4,6.0032
145,138,7,12,11.48,52,2011,4,7.0015
166,153,13,13,12.3,52,2011,4,7.0015
111,95,16,14,13.12,53,2011,4,8.9981
132,124,8,15,13.12,57,2011,4,7.0015
214,209,5,16,13.12,57,2011,4,6.0032
359,352,7,17,12.3,56,2011,4,10.07635574
357,349,8,18,12.3,56,2011,4,6.0032
241,232,9,19,11.48,61,2011,4,6.0032
165,157,8,20,12.3,56,2011,4,6.0032
121,119,2,21,10.66,81,2011,4,8.097488228
71,71,0,22,10.66,70,2011,4,9.608888083
45,42,3,23,9.84,75,2011,4,7.739902408
17,16,1,0,9.02,80,2011,4,7.724001059
4,4,0,1,8.2,80,2011,4,7.704556015
2,1,1,2,8.2,80,2011,4,7.704556015
3,3,0,3,7.38,80,2011,4,8.598061849
4,4,0,4,8.2,80,2011,4,7.704556015
20,20,0,5,7.38,86,2011,4,8.630460023
92,92,0,6,8.2,80,2011,4,7.704556015
223,221,2,7,6.56,80,2011,4,11.0014
400,391,9,8,8.2,69,2011,4,7.0015
233,223,10,9,10.66,60,2011,4,11.0014
102,99,3,10,12.3,52,2011,4,11.0014
124,115,9,11,13.94,46,2011,4,16.9979
167,147,20,12,14.76,43,2011,4,23.9994
127,120,7,13,16.4,37,2011,4,22.0028
134,116,18,14,16.4,37,2011,4,16.9979
151,144,7,15,16.4,35,2011,4,16.9979
207,194,13,16,15.58,37,2011,4,16.9979
398,381,17,17,14.76,40,2011,4,12.998
382,370,12,18,13.94,42,2011,4,15.0013
267,262,5,19,13.12,49,2011,4,11.0014
161,154,7,20,13.12,49,2011,4,11.0014
139,134,5,21,12.3,52,2011,4,11.0014
107,102,5,22,12.3,52,2011,4,11.0014
59,55,4,23,10.66,70,2011,4,9.608888083
22,22,0,0,10.66,75,2011,4,8.195059512
8,8,0,1,10.66,75,2011,4,8.195059512
2,2,0,2,10.66,75,2011,4,8.195059512
3,3,0,3,11.48,65,2011,4,9.727229913
4,4,0,4,10.66,75,2011,4,8.195059512
26,26,0,5,10.66,81,2011,4,9.703733486
87,87,0,6,10.66,87,2011,4,9.733796355
247,243,4,7,11.48,75,2011,4,8.391438338
467,458,9,8,10.66,87,2011,4,9.733796355
239,230,9,9,12.3,61,2011,4,10.00888638
142,133,9,10,13.12,57,2011,4,11.25536652
115,103,12,11,13.94,55,2011,4,11.45512845
144,138,6,12,14.76,57,2011,4,6.0032
133,119,14,13,14.76,57,2011,4,7.0015
151,134,17,14,15.58,54,2011,4,6.0032
167,143,24,15,15.58,54,2011,4,7.0015
245,233,12,16,15.58,54,2011,4,7.0015
396,377,19,17,14.76,57,2011,4,7.0015
390,379,11,18,14.76,62,2011,4,11.0014
268,259,9,19,14.76,62,2011,4,7.0015
175,169,6,20,13.94,66,2011,4,7.0015
154,145,9,21,13.94,66,2011,4,11.0014
104,99,5,22,13.94,66,2011,4,11.0014
51,48,3,23,13.12,70,2011,4,11.0014
50,45,5,0,13.12,70,2011,4,11.0014
20,15,5,1,13.12,70,2011,4,11.0014
7,5,2,2,13.12,70,2011,4,8.9981
3,2,1,3,13.12,70,2011,4,8.9981
6,6,0,4,13.12,70,2011,4,15.0013
24,24,0,5,13.12,70,2011,4,19.0012
92,90,2,6,13.12,66,2011,4,12.998
258,252,6,7,13.12,70,2011,4,12.998
457,449,8,8,13.94,66,2011,4,15.0013
280,274,6,9,14.76,62,2011,4,19.0012
109,105,4,10,16.4,58,2011,4,19.9995
135,126,9,11,16.4,62,2011,4,27.9993
157,140,17,12,18.86,59,2011,4,32.9975
164,150,14,13,20.5,55,2011,4,23.9994
132,124,8,14,21.32,52,2011,4,22.0028
82,76,6,15,21.32,55,2011,4,15.0013
131,124,7,16,18.86,72,2011,4,11.0014
324,310,14,17,21.32,59,2011,4,19.0012
377,363,14,18,21.32,59,2011,4,19.9995
287,274,13,19,21.32,59,2011,4,19.0012
221,209,12,20,21.32,59,2011,4,22.0028
155,145,10,21,20.5,63,2011,4,19.9995
124,116,8,22,21.32,63,2011,4,22.0028
114,104,10,23,21.32,63,2011,4,22.0028
72,60,12,0,20.5,72,2011,4,22.0028
31,28,3,1,20.5,72,2011,4,15.0013
23,23,0,2,19.68,77,2011,4,7.0015
5,3,2,3,18.86,82,2011,4,8.9981
5,4,1,4,20.5,59,2011,4,12.998
26,26,0,5,19.68,44,2011,4,26.0027
82,80,2,6,18.04,33,2011,4,19.9995
231,226,5,7,15.58,46,2011,4,19.9995
459,449,10,8,14.76,46,2011,4,27.9993
243,235,8,9,14.76,46,2011,4,26.0027
132,122,10,10,13.94,46,2011,4,19.9995
144,135,9,11,13.94,42,2011,4,19.9995
173,163,10,12,13.94,42,2011,4,23.9994
137,125,12,13,13.94,39,2011,4,23.9994
128,115,13,14,13.94,42,2011,4,15.0013
153,141,12,15,13.12,45,2011,4,19.9995
224,212,12,16,13.12,45,2011,4,15.0013
365,352,13,17,13.12,45,2011,4,19.0012
295,285,10,18,13.12,45,2011,4,16.9979
214,203,11,19,13.12,45,2011,4,15.0013
152,146,6,20,13.12,45,2011,4,12.998
102,95,7,21,13.12,45,2011,4,11.0014
106,100,6,22,12.3,49,2011,4,11.0014
75,71,4,23,12.3,49,2011,4,8.9981
62,59,3,0,12.3,49,2011,4,19.0012
43,39,4,1,12.3,52,2011,4,16.9979
58,47,11,2,11.48,56,2011,4,15.0013
26,22,4,3,10.66,60,2011,4,12.998
9,9,0,4,9.84,65,2011,4,11.0014
9,7,2,5,10.66,60,2011,4,12.998
17,17,0,6,10.66,56,2011,4,19.0012
20,20,0,7,10.66,56,2011,4,15.0013
59,55,4,8,10.66,56,2011,4,15.0013
100,95,5,9,10.66,56,2011,4,16.9979
181,171,10,10,10.66,52,2011,4,19.0012
209,188,21,11,11.48,45,2011,4,22.0028
244,216,28,12,11.48,45,2011,4,19.0012
236,204,32,13,11.48,48,2011,4,16.9979
237,207,30,14,11.48,45,2011,4,23.9994
228,195,33,15,11.48,45,2011,4,19.0012
222,192,30,16,11.48,45,2011,4,15.0013
165,153,12,17,10.66,48,2011,4,15.0013
157,150,7,18,10.66,48,2011,4,26.0027
106,95,11,19,9.84,65,2011,4,22.0028
106,99,7,20,9.02,69,2011,4,16.9979
96,88,8,21,8.2,75,2011,4,11.0014
80,73,7,22,8.2,75,2011,4,11.0014
69,63,6,23,8.2,75,2011,4,8.512298199
71,64,7,0,8.2,75,2011,4,8.9981
46,43,3,1,8.2,69,2011,4,7.0015
41,39,2,2,9.02,55,2011,4,7.0015
18,16,2,3,9.02,55,2011,4,15.0013
1,1,0,4,9.02,55,2011,4,15.0013
5,4,1,5,8.2,59,2011,4,7.0015
3,3,0,6,8.2,59,2011,4,8.9981
12,11,1,7,8.2,59,2011,4,11.0014
32,31,1,8,8.2,69,2011,4,7.65838142
81,75,6,9,9.02,64,2011,4,11.0014
129,122,7,10,9.84,60,2011,4,16.9979
188,168,20,11,9.84,60,2011,4,15.0013
228,202,26,12,10.66,60,2011,4,15.0013
228,210,18,13,12.3,49,2011,4,19.9995
219,200,19,14,12.3,49,2011,4,19.0012
207,184,23,15,13.12,45,2011,4,19.0012
234,207,27,16,11.48,48,2011,4,16.9979
136,126,10,17,11.48,46,2011,4,11.0014
138,123,15,18,11.48,45,2011,4,12.998
135,130,5,19,10.66,52,2011,4,8.9981
104,94,10,20,9.84,60,2011,4,7.0015
89,80,9,21,9.02,64,2011,4,8.201745257
49,47,2,22,9.02,75,2011,4,12.998
37,31,6,23,8.2,75,2011,4,7.0015
17,14,3,0,8.2,75,2011,4,6.0032
11,8,3,1,7.38,80,2011,4,6.0032
3,3,0,2,7.38,80,2011,4,6.0032
3,3,0,3,6.56,86,2011,4,6.0032
4,4,0,4,6.56,86,2011,4,8.9981
21,21,0,5,5.74,93,2011,4,7.0015
68,68,0,6,6.56,86,2011,4,7.0015
191,187,4,7,7.38,74,2011,4,7.0015
397,389,8,8,8.2,75,2011,4,12.998
183,166,17,9,9.02,69,2011,4,15.0013
108,96,12,10,9.84,67,2011,4,12.998
127,105,22,11,10.66,65,2011,4,16.9979
141,128,13,12,12.3,61,2011,4,22.0028
142,127,15,13,13.94,49,2011,4,22.0028
137,107,30,14,14.76,46,2011,4,15.0013
159,135,24,15,15.58,46,2011,4,11.0014
208,189,19,16,16.4,40,2011,4,16.9979
378,362,16,17,15.58,46,2011,4,12.998
354,343,11,18,14.76,50,2011,4,12.998
251,234,17,19,14.76,53,2011,4,11.0014
206,197,9,20,16.4,40,2011,4,11.0014
127,112,15,21,14.76,53,2011,4,8.9981
107,95,12,22,14.76,57,2011,4,11.0014
60,50,10,23,14.76,53,2011,4,11.0014
48,43,5,0,14.76,66,2012,1,12.14819019
93,78,15,1,14.76,66,2012,1,8.9981
75,59,16,2,13.12,76,2012,1,10.15465465
52,41,11,3,12.3,81,2012,1,9.525138093
8,8,0,4,11.48,81,2012,1,6.0032
5,5,0,5,11.48,81,2012,1,7.0015
2,1,1,6,10.66,93,2012,1,8.9981
7,6,1,7,10.66,93,2012,1,11.0014
14,10,4,8,10.66,87,2012,1,7.0015
40,27,13,9,10.66,93,2012,1,7.0015
70,52,18,10,12.3,81,2012,1,7.0015
138,98,40,11,13.94,76,2012,1,8.9981
201,143,58,12,16.4,62,2012,1,19.0012
223,141,82,13,17.22,58,2012,1,19.0012
267,147,120,14,18.04,54,2012,1,19.9995
265,164,101,15,18.86,51,2012,1,19.9995
215,147,68,16,18.04,54,2012,1,19.9995
111,75,36,17,19.68,48,2012,1,11.0014
106,81,25,18,18.86,59,2012,1,16.9979
105,85,20,19,17.22,67,2012,1,26.0027
83,58,25,20,18.04,62,2012,1,19.9995
71,61,10,21,18.04,67,2012,1,16.9979
66,53,13,22,18.86,55,2012,1,27.9993
29,25,4,23,18.04,51,2012,1,19.9995
39,31,8,0,16.4,40,2012,1,31.0009
12,11,1,1,14.76,43,2012,1,27.9993
7,6,1,2,14.76,34,2012,1,30.0026
4,4,0,4,11.48,45,2012,1,22.0028
4,3,1,5,11.48,45,2012,1,22.0028
14,14,0,6,10.66,41,2012,1,26.0027
16,16,0,7,9.84,32,2012,1,26.0027
53,51,2,8,9.84,35,2012,1,16.9979
68,53,15,9,9.84,35,2012,1,11.49535014
109,89,20,10,10.66,35,2012,1,19.0012
175,142,33,11,10.66,35,2012,1,32.9975
202,161,41,12,11.48,36,2012,1,16.9979
176,150,26,13,12.3,36,2012,1,19.9995
151,141,10,14,12.3,36,2012,1,27.9993
168,139,29,15,11.48,38,2012,1,30.0026
154,144,10,16,10.66,35,2012,1,27.9993
153,136,17,17,10.66,35,2012,1,26.0027
126,113,13,18,10.66,33,2012,1,16.9979
93,89,4,19,9.84,38,2012,1,15.0013
88,83,5,20,9.84,41,2012,1,15.0013
66,63,3,21,9.84,41,2012,1,22.0028
39,36,3,22,9.02,44,2012,1,19.0012
34,32,2,23,9.02,44,2012,1,16.9979
13,13,0,0,8.2,51,2012,1,16.9979
6,5,1,1,7.38,55,2012,1,15.0013
3,3,0,2,7.38,51,2012,1,16.9979
2,2,0,3,6.56,55,2012,1,19.0012
5,5,0,4,6.56,55,2012,1,16.9979
12,12,0,5,5.74,54,2012,1,12.998
85,81,4,6,5.74,59,2012,1,19.0012
170,168,2,7,5.74,59,2012,1,16.9979
354,349,5,8,6.56,55,2012,1,19.0012
153,145,8,9,6.56,50,2012,1,19.0012
60,55,5,10,6.56,47,2012,1,31.0009
75,63,12,11,7.38,37,2012,1,35.0008
74,70,4,12,7.38,37,2012,1,35.0008
73,68,5,13,7.38,34,2012,1,43.9989
79,72,7,14,6.56,43,2012,1,35.0008
77,68,9,15,6.56,37,2012,1,27.9993
136,129,7,16,5.74,39,2012,1,39.0007
245,241,4,17,5.74,26,2012,1,31.0009
224,214,10,18,5.74,26,2012,1,35.0008
156,152,4,19,4.92,28,2012,1,27.9993
115,115,0,20,4.92,33,2012,1,16.9979
68,66,2,21,4.1,36,2012,1,15.0013
33,33,0,22,4.1,46,2012,1,16.9979
18,18,0,23,4.1,46,2012,1,26.0027
9,9,0,0,3.28,42,2012,1,22.0028
3,3,0,1,1.64,38,2012,1,19.9995
1,1,0,2,0.82,34,2012,1,19.0012
1,1,0,3,0.82,34,2012,1,19.0012
2,2,0,4,0.82,41,2012,1,12.998
14,14,0,5,0.82,41,2012,1,12.998
59,59,0,6,0.82,41,2012,1,11.0014
152,151,1,7,0.82,44,2012,1,12.998
315,310,5,8,0.82,44,2012,1,8.9981
180,173,7,9,1.64,45,2012,1,8.9981
64,57,7,10,2.46,45,2012,1,11.093385
46,40,6,11,3.28,42,2012,1,6.0032
84,75,9,12,4.1,46,2012,1,12.998
91,82,9,13,5.74,43,2012,1,16.9979
75,69,6,14,5.74,46,2012,1,16.9979
90,81,9,15,7.38,37,2012,1,22.0028
131,123,8,16,7.38,40,2012,1,19.0012
281,272,9,17,8.2,40,2012,1,12.998
289,280,9,18,8.2,37,2012,1,8.9981
184,182,2,19,8.2,40,2012,1,7.0015
123,121,2,20,8.2,40,2012,1,12.998
90,88,2,21,8.2,44,2012,1,7.495435564
52,48,4,22,8.2,47,2012,1,6.0032
32,32,0,23,8.2,44,2012,1,7.0015
14,13,1,0,9.02,47,2012,1,12.998
5,5,0,1,8.2,51,2012,1,6.0032
4,4,0,2,8.2,51,2012,1,6.0032
4,4,0,3,8.2,61,2012,1,6.808537953
5,5,0,4,8.2,59,2012,1,6.0032
26,26,0,5,8.2,59,2012,1,6.0032
78,78,0,6,8.2,75,2012,1,8.9981
215,212,3,7,8.2,69,2012,1,6.0032
388,377,11,8,8.2,75,2012,1,8.607933618
227,220,7,9,9.02,69,2012,1,9.013514529
86,81,5,10,9.84,52,2012,1,6.0032
84,78,6,11,12.3,49,2012,1,9.905792726
120,114,6,12,12.3,49,2012,1,16.9979
118,112,6,13,13.94,42,2012,1,19.9995
117,104,13,14,13.94,39,2012,1,19.0012
119,113,6,15,14.76,34,2012,1,19.0012
197,178,19,16,14.76,34,2012,1,19.0012
412,393,19,17,14.76,34,2012,1,12.998
383,374,9,18,13.94,36,2012,1,11.0014
265,255,10,19,13.94,34,2012,1,6.0032
177,172,5,20,12.3,49,2012,1,9.905792726
97,88,9,21,10.66,60,2012,1,8.9981
71,70,1,22,10.66,60,2012,1,11.0014
60,56,4,23,9.84,70,2012,1,7.0015
25,24,1,0,9.02,75,2012,1,6.0032
8,6,2,1,9.02,75,2012,1,8.26592116
5,3,2,2,9.02,69,2012,1,11.0014
4,3,1,3,9.02,69,2012,1,7.0015
3,3,0,4,9.02,69,2012,1,8.9981
13,13,0,5,8.2,80,2012,1,8.9981
70,69,1,6,9.02,73,2012,1,7.0015
205,201,4,7,9.84,65,2012,1,9.263115478
447,436,11,8,9.84,70,2012,1,8.9981
241,237,4,9,9.84,70,2012,1,11.0014
116,102,14,10,10.66,65,2012,1,12.998
138,130,8,11,12.3,56,2012,1,11.0014
191,168,23,12,14.76,50,2012,1,16.9979
204,188,16,13,16.4,43,2012,1,19.0012
178,152,26,14,18.86,36,2012,1,12.998
222,178,44,15,21.32,27,2012,1,16.9979
294,259,35,16,21.32,27,2012,1,19.0012
476,456,20,17,18.86,36,2012,1,15.0013
419,391,28,18,20.5,29,2012,1,16.9979
272,261,11,19,18.86,33,2012,1,19.0012
177,163,14,20,17.22,41,2012,1,12.998
154,137,17,21,16.4,43,2012,1,15.0013
135,123,12,22,14.76,50,2012,1,12.998
101,88,13,23,14.76,50,2012,1,15.99516033
79,77,2,0,14.76,50,2012,1,11.0014
62,56,6,1,15.58,46,2012,1,11.0014
38,36,2,2,14.76,50,2012,1,7.0015
20,19,1,3,13.12,57,2012,1,7.0015
10,9,1,4,13.12,57,2012,1,6.0032
9,7,2,5,10.66,75,2012,1,7.0015
7,7,0,6,10.66,75,2012,1,7.0015
20,20,0,7,9.02,87,2012,1,12.998
64,64,0,8,9.84,75,2012,1,7.0015
130,116,14,9,9.02,80,2012,1,8.9981
203,160,43,10,11.48,75,2012,1,6.0032
324,250,74,11,13.94,57,2012,1,15.0013
376,276,100,12,16.4,43,2012,1,15.0013
445,296,149,13,18.04,44,2012,1,12.998
512,356,156,14,20.5,42,2012,1,19.0012
449,317,132,15,23.78,37,2012,1,19.9995
401,268,133,16,22.96,37,2012,1,19.0012
322,235,87,17,22.14,43,2012,1,8.9981
297,248,49,18,22.14,45,2012,1,8.9981
215,171,44,19,21.32,42,2012,1,7.0015
170,149,21,20,20.5,39,2012,1,16.9979
140,118,22,21,18.04,44,2012,1,15.0013
109,93,16,22,18.04,38,2012,1,16.9979
119,103,16,23,17.22,38,2012,1,15.0013
91,77,14,0,15.58,40,2012,1,19.0012
72,62,10,1,13.94,42,2012,1,12.998
67,57,10,2,14.76,37,2012,1,19.0012
32,26,6,3,13.94,42,2012,1,8.9981
6,4,2,4,13.12,49,2012,1,16.9979
2,2,0,5,13.12,49,2012,1,7.0015
2,2,0,6,12.3,52,2012,1,10.1733928
24,23,1,7,12.3,52,2012,1,10.1733928
57,53,4,8,12.3,52,2012,1,8.9981
125,102,23,9,13.12,53,2012,1,8.9981
208,181,27,10,13.94,49,2012,1,11.0014
256,201,55,11,14.76,46,2012,1,15.0013
351,273,78,12,15.58,43,2012,1,15.0013
343,266,77,13,16.4,37,2012,1,19.9995
328,253,75,14,16.4,40,2012,1,12.998
330,241,89,15,16.4,37,2012,1,19.0012
314,256,58,16,16.4,37,2012,1,19.9995
219,197,22,17,15.58,40,2012,1,15.0013
181,162,19,18,13.94,46,2012,1,15.0013
112,104,8,19,13.12,49,2012,1,12.998
126,119,7,20,12.3,52,2012,1,11.0014
91,81,10,21,11.48,56,2012,1,15.0013
58,54,4,22,10.66,60,2012,1,7.0015
30,30,0,23,10.66,56,2012,1,16.9979
15,12,3,0,9.84,60,2012,1,15.0013
5,4,1,1,9.84,60,2012,1,8.9981
5,3,2,2,9.84,56,2012,1,8.9981
3,3,0,3,9.84,52,2012,1,11.0014
4,4,0,4,9.02,64,2012,1,7.0015
21,21,0,5,8.2,64,2012,1,6.0032
88,85,3,6,9.02,60,2012,1,8.9981
240,239,1,7,9.02,60,2012,1,7.0015
420,407,13,8,9.02,55,2012,1,6.0032
197,188,9,9,9.02,64,2012,1,8.360021198
108,95,13,10,9.84,60,2012,1,7.401408358
88,82,6,11,10.66,56,2012,1,6.0032
103,93,10,12,10.66,56,2012,1,7.0015
80,77,3,13,10.66,56,2012,1,7.0015
50,45,5,14,9.02,75,2012,1,11.0014
69,64,5,15,9.02,75,2012,1,11.0014
49,46,3,16,9.02,87,2012,1,6.0032
152,147,5,17,9.02,87,2012,1,9.009908263
164,158,6,18,8.2,86,2012,1,6.0032
190,187,3,19,8.2,93,2012,1,6.0032
132,127,5,20,8.2,86,2012,1,6.0032
79,78,1,21,8.2,93,2012,1,8.114272044
62,54,8,22,8.2,92,2012,1,7.0015
52,51,1,23,9.02,87,2012,1,7.0015
14,14,0,0,9.02,87,2012,1,7.0015
5,3,2,1,9.02,93,2012,1,7.0015
4,2,2,2,9.02,87,2012,1,11.0014
4,4,0,4,8.2,86,2012,1,11.0014
23,23,0,5,16.4,47,2012,1,15.0013
79,79,0,6,7.38,93,2012,1,12.998
222,219,3,7,7.38,93,2012,1,11.0014
471,465,6,8,7.38,93,2012,1,11.0014
195,184,11,9,7.38,93,2012,1,11.0014
83,80,3,10,7.38,93,2012,1,11.0014
101,93,8,11,17.22,38,2012,1,19.9995
140,127,13,12,17.22,38,2012,1,19.9995
178,163,15,13,17.22,38,2012,1,19.9995
106,96,10,14,17.22,38,2012,1,19.9995
136,119,17,15,17.22,38,2012,1,19.9995
240,225,15,16,17.22,38,2012,1,23.9994
460,446,14,17,17.22,38,2012,1,16.9979
385,372,13,18,16.4,40,2012,1,7.0015
281,270,11,19,15.58,46,2012,1,7.0015
200,190,10,20,13.94,53,2012,1,7.0015
116,109,7,21,13.12,66,2012,1,6.0032
114,104,10,22,12.3,70,2012,1,6.0032
41,38,3,23,10.66,81,2012,1,7.0015
28,26,2,0,10.66,81,2012,1,8.692658009
7,6,1,1,9.84,87,2012,1,6.0032
5,5,0,2,8.2,85,2012,1,11.0014
4,4,0,3,9.02,80,2012,1,7.986576124
2,2,0,4,8.2,80,2012,1,8.9981
22,22,0,5,8.2,80,2012,1,8.9981
74,72,2,6,8.2,86,2012,1,8.9981
256,247,9,7,8.2,80,2012,1,8.9981
499,488,11,8,8.2,82,2012,1,7.0015
225,218,7,9,8.2,86,2012,1,8.9981
97,84,13,10,9.84,87,2012,1,8.9981
99,90,9,11,10.66,87,2012,1,6.0032
55,51,4,12,12.3,81,2012,1,12.01461809
65,57,8,13,13.12,76,2012,1,12.36521875
73,70,3,14,13.12,81,2012,1,7.0015
79,73,6,15,13.94,87,2012,1,6.0032
118,112,6,16,13.94,87,2012,1,16.9979
134,128,6,17,13.94,87,2012,1,15.0013
98,96,2,18,13.94,87,2012,1,12.998
93,92,1,19,13.12,93,2012,1,15.0013
57,55,2,20,13.12,93,2012,1,11.0014
29,29,0,21,13.94,87,2012,1,15.0013
49,49,0,22,13.94,87,2012,1,12.998
9,9,0,23,13.94,87,2012,1,15.0013
3,3,0,0,13.94,93,2012,1,12.998
3,3,0,1,14.76,93,2012,1,12.998
2,1,1,2,14.76,93,2012,1,16.9979
3,3,0,3,14.76,93,2012,1,16.9979
2,2,0,4,14.76,93,2012,1,12.998
16,16,0,5,13.94,93,2012,1,6.0032
89,88,1,6,14.76,93,2012,1,8.9981
220,218,2,7,13.94,87,2012,1,19.0012
508,497,11,8,13.12,81,2012,1,12.998
230,220,10,9,13.12,81,2012,1,7.0015
90,84,6,10,13.94,81,2012,1,7.0015
119,101,18,11,13.94,81,2012,1,7.0015
144,130,14,12,13.94,81,2012,1,7.0015
183,170,13,13,17.22,77,2012,1,11.0014
156,132,24,14,17.22,77,2012,1,11.0014
188,156,32,15,18.04,72,2012,1,8.9981
281,248,33,16,18.86,67,2012,1,12.998
495,472,23,17,18.86,63,2012,1,11.0014
421,399,22,18,18.04,67,2012,1,12.998
330,313,17,19,17.22,71,2012,1,11.0014
240,229,11,20,17.22,71,2012,1,12.998
174,162,12,21,18.04,67,2012,1,8.9981
133,121,12,22,15.58,76,2012,1,19.9995
67,60,7,23,16.4,76,2012,1,22.0028
42,38,4,0,16.4,71,2012,1,19.0012
12,12,0,1,15.58,76,2012,1,19.9995
14,13,1,2,16.4,76,2012,1,23.9994
7,4,3,3,14.76,87,2012,1,16.9979
3,2,1,4,13.12,70,2012,1,32.9975
21,21,0,5,12.3,70,2012,1,36.9974
73,71,2,6,10.66,75,2012,1,15.0013
177,174,3,7,10.66,60,2012,1,15.0013
419,408,11,8,9.84,52,2012,1,23.9994
214,204,10,9,9.02,47,2012,1,26.0027
103,101,2,10,9.84,44,2012,1,30.0026
114,102,12,11,9.84,38,2012,1,40.9973
154,140,14,12,9.84,38,2012,1,32.9975
154,140,14,13,10.66,33,2012,1,35.0008
129,119,10,14,10.66,33,2012,1,36.9974
138,123,15,15,10.66,33,2012,1,39.0007
233,215,18,16,11.48,30,2012,1,31.0009
332,317,15,17,11.48,33,2012,1,27.9993
301,294,7,18,10.66,38,2012,1,19.9995
206,199,7,19,10.66,38,2012,1,19.0012
136,130,6,20,9.84,41,2012,1,11.0014
102,95,7,21,9.84,41,2012,1,19.0012
65,58,7,22,8.2,47,2012,1,22.0028
65,60,5,23,7.38,47,2012,1,12.998
44,42,2,0,6.56,47,2012,1,7.0015
50,44,6,1,6.56,47,2012,1,12.998
38,32,6,2,6.56,47,2012,1,11.0014
20,14,6,3,5.74,54,2012,1,7.0015
3,3,0,4,5.74,50,2012,1,8.9981
4,4,0,5,5.74,50,2012,1,8.9981
5,5,0,6,5.74,50,2012,1,11.63311602
24,24,0,7,5.74,50,2012,1,8.9981
92,89,3,8,4.92,54,2012,1,7.0015
81,78,3,9,5.74,50,2012,1,7.0015
149,135,14,10,6.56,47,2012,1,7.473129497
178,150,28,11,8.2,40,2012,1,12.998
219,189,30,12,9.02,41,2012,1,16.9979
220,182,38,13,9.02,44,2012,1,19.0012
231,179,52,14,9.84,41,2012,1,19.9995
226,177,49,15,9.84,38,2012,1,19.9995
206,178,28,16,9.84,38,2012,1,15.0013
144,129,15,17,9.84,41,2012,1,16.9979
143,122,21,18,9.02,41,2012,1,12.998
102,90,12,19,8.2,47,2012,1,15.0013
103,95,8,20,8.2,44,2012,1,16.9979
69,66,3,21,7.38,43,2012,1,16.9979
66,62,4,22,6.56,47,2012,1,23.9994
76,71,5,23,6.56,47,2012,1,15.0013
59,50,9,0,6.56,47,2012,1,22.0028
42,40,2,1,6.56,47,2012,1,19.9995
43,38,5,2,6.56,47,2012,1,19.0012
25,24,1,3,6.56,48,2012,1,26.0027
6,5,1,4,6.56,47,2012,1,26.0027
5,5,0,5,6.56,47,2012,1,22.0028
8,7,1,6,5.74,50,2012,1,19.0012
17,14,3,7,4.92,54,2012,1,19.0012
36,34,2,8,4.92,54,2012,1,15.0013
90,80,10,9,4.92,54,2012,1,12.998
126,115,11,10,5.74,54,2012,1,19.0012
165,144,21,11,6.56,47,2012,1,15.0013
234,192,42,12,7.38,40,2012,1,19.9995
224,184,40,13,8.2,34,2012,1,19.0012
188,163,25,14,8.2,32,2012,1,23.9994
206,173,33,15,9.02,27,2012,1,12.998
205,174,31,16,9.02,29,2012,1,19.9995
146,131,15,17,9.02,25,2012,1,16.9979
120,113,7,18,7.38,29,2012,1,15.0013
110,101,9,19,6.56,37,2012,1,11.0014
95,85,10,20,6.56,37,2012,1,7.0015
72,71,1,21,6.56,40,2012,1,11.0014
60,58,2,22,7.38,37,2012,1,6.0032
29,26,3,23,6.56,43,2012,1,6.0032
25,23,2,0,5.74,46,2012,1,8.9981
20,18,2,1,5.74,43,2012,1,7.0015
17,14,3,2,5.74,46,2012,1,9.084351034
3,3,0,3,4.92,50,2012,1,10.1212608
8,6,2,4,4.92,58,2012,1,7.0015
6,5,1,5,4.92,54,2012,1,6.0032
13,13,0,6,4.1,54,2012,1,6.0032
33,28,5,7,4.1,54,2012,1,7.0015
78,75,3,8,4.1,58,2012,1,11.0014
96,89,7,9,4.1,58,2012,1,11.0014
126,107,19,10,5.74,59,2012,1,12.998
179,158,21,11,6.56,59,2012,1,16.9979
185,165,20,12,8.2,55,2012,1,22.0028
228,202,26,13,9.84,41,2012,1,27.9993
181,158,23,14,9.84,44,2012,1,26.0027
192,175,17,15,10.66,44,2012,1,30.0026
180,158,22,16,10.66,44,2012,1,23.9994
193,174,19,17,10.66,48,2012,1,22.0028
181,175,6,18,10.66,52,2012,1,22.0028
144,134,10,19,10.66,56,2012,1,19.0012
90,88,2,20,10.66,60,2012,1,19.0012
49,46,3,21,11.48,52,2012,1,22.0028
43,39,4,22,12.3,49,2012,1,23.9994
28,28,0,23,10.66,70,2012,1,19.9995
12,12,0,0,10.66,70,2012,1,22.0028
2,2,0,1,11.48,65,2012,1,23.9994
12,12,0,2,11.48,75,2012,1,16.9979
2,2,0,4,13.12,66,2012,1,22.0028
13,13,0,5,13.12,66,2012,1,22.0028
57,57,0,6,12.3,75,2012,1,16.9979
126,121,5,7,12.3,81,2012,1,15.0013
93,90,3,8,12.3,81,2012,1,19.0012
68,61,7,9,13.12,81,2012,1,16.9979
62,61,1,10,12.3,87,2012,1,16.9979
75,73,2,11,13.94,87,2012,1,7.0015
86,83,3,12,13.12,87,2012,1,19.0012
103,95,8,13,15.58,76,2012,1,22.0028
132,120,12,14,18.04,62,2012,1,32.9975
129,123,6,15,18.04,62,2012,1,32.9975
219,205,14,16,18.86,63,2012,1,36.9974
462,442,20,17,18.86,63,2012,1,30.0026
463,451,12,18,18.86,63,2012,1,30.0026
308,297,11,19,18.86,63,2012,1,27.9993
180,169,11,20,18.86,63,2012,1,23.9994
180,174,6,21,18.86,67,2012,1,31.0009
90,85,5,22,18.86,72,2012,1,26.0027
61,60,1,23,18.86,72,2012,1,26.0027
17,14,3,0,18.86,77,2012,1,22.0028
10,10,0,1,18.86,77,2012,1,22.0028
2,1,1,2,18.04,51,2012,1,32.9975
4,3,1,3,18.04,51,2012,1,32.9975
1,1,0,4,13.94,46,2012,1,35.0008
29,29,0,5,13.94,46,2012,1,35.0008
88,88,0,6,13.94,36,2012,1,35.0008
263,262,1,7,13.12,42,2012,1,23.9994
489,474,15,8,12.3,52,2012,1,27.9993
202,196,6,9,11.48,52,2012,1,22.0028
93,88,5,10,12.3,42,2012,1,31.0009
114,110,4,11,12.3,42,2012,1,26.0027
161,155,6,12,12.3,39,2012,1,32.9975
130,124,6,13,12.3,42,2012,1,31.0009
105,98,7,14,12.3,33,2012,1,26.0027
130,122,8,15,12.3,33,2012,1,35.0008
176,163,13,16,11.48,30,2012,1,35.0008
346,338,8,17,10.66,33,2012,1,30.0026
355,347,8,18,9.84,32,2012,1,23.9994
256,251,5,19,9.02,37,2012,1,26.0027
165,164,1,20,9.02,37,2012,1,16.9979
124,119,5,21,8.2,40,2012,1,27.9993
78,74,4,22,7.38,47,2012,1,16.9979
38,36,2,23,6.56,47,2012,1,19.9995
16,16,0,0,5.74,50,2012,1,12.998
5,5,0,1,5.74,50,2012,1,11.0014
3,3,0,2,5.74,50,2012,1,8.9981
4,4,0,3,4.92,54,2012,1,7.0015
1,1,0,4,4.92,54,2012,1,7.0015
19,19,0,5,4.92,55,2012,1,16.9979
86,86,0,6,4.92,54,2012,1,11.0014
206,204,2,7,4.92,54,2012,1,6.0032
423,414,9,8,4.92,54,2012,1,7.0015
210,204,6,9,4.92,54,2012,1,7.71428889
108,98,10,10,5.74,59,2012,1,7.809948171
99,93,6,11,6.56,55,2012,1,11.0014
111,106,5,12,8.2,51,2012,1,12.998
124,118,6,13,9.02,47,2012,1,19.0012
119,104,15,14,9.84,44,2012,1,12.998
127,118,9,15,10.66,44,2012,1,19.9995
193,185,8,16,10.66,41,2012,1,22.0028
385,364,21,17,10.66,44,2012,1,22.0028
361,345,16,18,10.66,44,2012,1,22.0028
234,229,5,19,10.66,48,2012,1,19.9995
191,184,7,20,10.66,52,2012,1,30.0026
121,117,4,21,10.66,44,2012,1,23.9994
90,90,0,22,10.66,44,2012,1,27.9993
56,55,1,23,10.66,48,2012,1,22.0028
31,31,0,0,18.04,38,2012,1,19.0012
4,4,0,1,18.04,41,2012,1,19.0012
7,6,1,2,18.04,44,2012,1,19.0012
3,3,0,3,18.04,44,2012,1,12.998
1,1,0,4,16.4,50,2012,1,11.0014
18,18,0,5,16.4,50,2012,1,11.0014
67,67,0,6,16.4,54,2012,1,11.0014
208,201,7,7,15.58,62,2012,1,6.0032
520,505,15,8,14.76,73,2012,1,7.0015
276,267,9,9,14.76,71,2012,1,12.998
133,124,9,10,16.4,62,2012,1,8.9981
143,116,27,11,16.4,58,2012,1,11.0014
179,153,26,12,18.04,54,2012,1,7.0015
186,174,12,13,18.86,47,2012,1,15.0013
192,159,33,14,25.42,33,2012,1,15.0013
194,169,25,15,24.6,35,2012,1,19.0012
283,261,22,16,24.6,40,2012,1,15.0013
539,508,31,17,23.78,43,2012,1,12.998
526,514,12,18,22.96,46,2012,1,11.0014
335,315,20,19,22.14,52,2012,1,19.0012
264,254,10,20,21.32,52,2012,1,11.0014
233,217,16,21,21.32,52,2012,1,11.0014
140,133,7,22,20.5,55,2012,1,12.998
97,75,22,23,18.86,63,2012,1,6.0032
31,24,7,0,18.86,59,2012,1,8.9981
17,14,3,1,18.86,55,2012,1,15.26617513
9,7,2,2,17.22,67,2012,1,8.9981
2,2,0,3,17.22,67,2012,1,8.9981
1,1,0,4,16.4,82,2012,1,6.0032
19,19,0,5,16.4,82,2012,1,12.99395946
74,73,1,6,14.76,90,2012,1,12.6851618
205,201,4,7,14.76,93,2012,1,13.23562532
445,436,9,8,16.4,87,2012,1,13.03582088
228,213,15,9,15.58,87,2012,1,12.86198041
78,72,6,10,17.22,77,2012,1,7.0015
105,99,6,11,16.4,82,2012,1,16.9979
148,140,8,12,17.22,82,2012,1,12.12683612
137,124,13,13,17.22,77,2012,1,12.84879601
141,129,12,14,16.4,76,2012,1,7.0015
174,150,24,15,18.86,67,2012,1,11.0014
229,211,18,16,18.86,55,2012,1,19.0012
450,437,13,17,17.22,54,2012,1,32.9975
410,393,17,18,16.4,43,2012,1,31.0009
327,311,16,19,15.58,43,2012,1,35.0008
213,204,9,20,14.76,46,2012,1,35.0008
148,144,4,21,13.94,46,2012,1,27.9993
109,106,3,22,13.12,49,2012,1,27.9993
61,61,0,23,13.12,49,2012,1,16.9979
38,37,1,0,13.12,53,2012,1,26.0027
22,19,3,1,12.3,56,2012,1,22.0028
6,6,0,2,12.3,52,2012,1,15.0013
4,4,0,3,11.48,56,2012,1,19.9995
2,2,0,4,10.66,60,2012,1,15.0013
17,17,0,5,10.66,60,2012,1,15.0013
88,88,0,6,9.84,65,2012,1,11.0014
226,216,10,7,9.84,65,2012,1,15.0013
441,429,12,8,9.84,65,2012,1,15.0013
270,252,18,9,9.84,65,2012,1,12.998
129,114,15,10,11.48,56,2012,1,19.0012
164,149,15,11,13.12,53,2012,1,19.9995
216,191,25,12,13.94,46,2012,1,8.9981
198,173,25,13,14.76,46,2012,1,14.23375761
170,148,22,14,14.76,46,2012,1,15.0013
216,168,48,15,15.58,40,2012,1,18.72806345
311,275,36,16,16.4,37,2012,1,7.0015
488,458,30,17,16.4,37,2012,1,6.0032
385,368,17,18,15.58,40,2012,1,8.9981
267,256,11,19,13.94,49,2012,1,7.0015
163,155,8,20,13.94,49,2012,1,7.0015
134,126,8,21,13.94,49,2012,1,7.0015
119,116,3,22,13.94,49,2012,1,7.0015
77,74,3,23,10.66,70,2012,1,7.0015
86,76,10,0,10.66,70,2012,1,7.0015
43,43,0,1,10.66,70,2012,1,7.0015
44,38,6,2,9.84,70,2012,1,6.0032
18,17,1,3,9.84,75,2012,1,8.310282496
6,5,1,4,9.84,81,2012,1,6.0032
4,3,1,5,9.84,81,2012,1,6.0032
5,4,1,6,9.02,87,2012,1,8.9981
28,27,1,7,9.84,87,2012,1,8.9981
90,86,4,8,9.84,87,2012,1,7.770103754
157,141,16,9,9.84,81,2012,1,8.9981
224,193,31,10,9.84,87,2012,1,7.0015
270,224,46,11,12.3,70,2012,1,9.572796801
300,260,40,12,12.3,70,2012,1,6.0032
302,244,58,13,12.3,70,2012,1,12.998
276,229,47,14,13.12,66,2012,1,15.0013
305,244,61,15,13.12,66,2012,1,15.0013
143,123,20,16,13.94,61,2012,1,11.0014
67,54,13,17,12.3,70,2012,1,12.998
64,58,6,18,11.48,75,2012,1,11.0014
80,75,5,19,10.66,87,2012,1,8.9981
77,73,4,20,9.84,93,2012,1,12.998
78,74,4,21,9.84,93,2012,1,8.9981
95,91,4,22,9.84,87,2012,1,6.0032
70,66,4,23,9.84,87,2012,1,8.9981
61,58,3,0,9.84,87,2012,1,8.9981
51,46,5,1,9.84,93,2012,1,7.0015
63,59,4,2,9.84,93,2012,1,7.0015
17,13,4,3,9.84,87,2012,1,6.0032
9,9,0,4,9.84,87,2012,1,8.9981
4,4,0,5,10.66,81,2012,1,12.998
4,4,0,6,10.66,70,2012,1,16.9979
16,16,0,7,9.84,75,2012,1,11.0014
62,58,4,8,9.84,75,2012,1,11.0014
92,83,9,9,9.84,70,2012,1,15.0013
148,138,10,10,10.66,65,2012,1,19.0012
182,160,22,11,10.66,70,2012,1,12.998
248,223,25,12,10.66,65,2012,1,12.998
274,241,33,13,11.48,61,2012,1,11.0014
243,203,40,14,12.3,61,2012,1,11.0014
272,217,55,15,12.3,56,2012,1,16.9979
296,261,35,16,12.3,56,2012,1,15.0013
306,275,31,17,13.12,53,2012,1,11.0014
181,171,10,18,12.3,52,2012,1,16.9979
69,63,6,19,12.3,52,2012,1,15.0013
50,47,3,20,11.48,56,2012,1,12.998
66,60,6,21,11.48,56,2012,1,7.0015
191,182,9,22,10.66,60,2012,1,7.0015
42,38,4,23,9.84,70,2012,1,8.9981
21,14,7,0,9.84,65,2012,1,8.9981
6,6,0,1,9.02,75,2012,1,6.0032
3,3,0,2,9.02,75,2012,1,8.26914661
2,2,0,4,7.38,80,2012,1,7.0015
17,17,0,5,7.38,80,2012,1,7.0015
72,72,0,6,6.56,86,2012,1,7.0015
234,229,5,7,6.56,86,2012,1,7.0015
444,434,10,8,6.56,86,2012,1,8.9981
277,269,8,9,7.38,80,2012,1,7.0015
116,96,20,10,9.02,75,2012,1,7.0015
116,104,12,11,10.66,70,2012,1,8.9981
150,131,19,12,13.12,61,2012,1,11.0014
141,124,17,13,15.58,40,2012,1,15.0013
140,126,14,14,16.4,35,2012,1,11.0014
171,146,25,15,17.22,32,2012,1,19.0012
228,215,13,16,16.4,43,2012,1,16.9979
430,417,13,17,16.4,43,2012,1,16.9979
437,426,11,18,15.58,43,2012,1,15.0013
291,284,7,19,14.76,43,2012,1,16.9979
201,194,7,20,13.94,46,2012,1,11.0014
154,143,11,21,13.12,57,2012,1,11.0014
87,83,4,22,12.3,65,2012,1,8.9981
46,43,3,23,12.3,65,2012,1,8.9981
23,22,1,0,12.3,70,2012,1,12.998
14,6,8,1,11.48,61,2012,1,8.9981
4,4,0,2,12.3,61,2012,1,10.58412288
2,1,1,3,12.3,70,2012,1,9.621668598
3,3,0,4,12.3,70,2012,1,9.621668598
15,15,0,5,13.12,49,2012,1,6.0032
100,98,2,6,13.12,45,2012,1,19.9995
299,293,6,7,13.12,45,2012,1,10.67454447
529,522,7,8,12.3,49,2012,1,9.867676392
289,278,11,9,13.12,49,2012,1,10.89938915
116,104,12,10,13.94,46,2012,1,11.0014
129,120,9,11,14.76,46,2012,1,12.998
172,163,9,12,16.4,40,2012,1,22.0028
184,169,15,13,18.04,38,2012,1,16.9979
138,127,11,14,18.04,38,2012,1,16.9979
146,133,13,15,18.04,38,2012,1,12.998
276,257,19,16,18.04,35,2012,1,16.9979
509,494,15,17,18.04,35,2012,1,12.998
518,508,10,18,17.22,38,2012,1,12.998
338,327,11,19,15.58,43,2012,1,15.0013
212,206,6,20,14.76,50,2012,1,8.9981
190,170,20,21,13.94,61,2012,1,7.0015
118,107,11,22,13.12,57,2012,1,12.998
51,49,2,23,13.12,57,2012,1,8.9981
23,21,2,0,12.3,56,2012,1,15.0013
10,9,1,1,11.48,61,2012,1,11.0014
1,1,0,2,10.66,65,2012,1,9.464184727
1,1,0,3,10.66,65,2012,1,9.464184727
1,1,0,4,9.84,70,2012,1,6.0032
20,20,0,5,9.84,70,2012,1,6.0032
98,95,3,6,9.84,70,2012,1,8.901608732
281,276,5,7,9.84,70,2012,1,7.0015
508,495,13,8,9.84,70,2012,1,15.0013
253,245,8,9,9.84,70,2012,1,11.0014
108,107,1,10,10.66,70,2012,1,15.0013
102,97,5,11,10.66,65,2012,1,15.0013
138,124,14,12,11.48,65,2012,1,19.0012
126,111,15,13,11.48,61,2012,1,7.0015
108,100,8,14,12.3,56,2012,1,11.0014
54,49,5,15,12.3,61,2012,1,7.0015
75,73,2,16,10.66,81,2012,1,7.0015
155,147,8,17,9.84,87,2012,1,7.0015
167,163,4,18,9.84,87,2012,1,7.0015
161,158,3,19,9.84,87,2012,1,7.0015
125,122,3,20,9.84,87,2012,1,8.9981
129,126,3,21,9.84,87,2012,1,12.998
98,95,3,22,9.84,87,2012,1,8.9981
60,57,3,23,9.84,87,2012,1,11.0014
26,23,3,0,9.84,87,2012,1,11.0014
12,10,2,1,9.84,87,2012,1,8.9981
2,2,0,2,9.02,80,2012,1,8.9981
4,4,0,3,9.02,80,2012,1,19.0012
1,1,0,4,9.02,75,2012,1,30.0026
18,18,0,5,8.2,75,2012,1,19.0012
76,75,1,6,8.2,75,2012,1,19.0012
267,263,4,7,8.2,69,2012,1,16.9979
484,473,11,8,8.2,64,2012,1,16.9979
238,229,9,9,8.2,59,2012,1,15.0013
97,90,7,10,9.02,51,2012,1,15.0013
99,95,4,11,9.84,52,2012,1,15.0013
158,148,10,12,10.66,48,2012,1,22.0028
154,144,10,13,12.3,42,2012,1,22.0028
144,126,18,14,13.12,39,2012,1,19.9995
134,120,14,15,13.12,36,2012,1,19.9995
238,223,15,16,13.94,36,2012,1,12.49432251
399,387,12,17,13.94,34,2012,1,8.9981
417,404,13,18,13.94,31,2012,1,11.0014
295,287,8,19,13.12,33,2012,1,7.0015
199,197,2,20,13.12,36,2012,1,8.650074925
177,169,8,21,12.3,52,2012,1,6.0032
107,104,3,22,12.3,56,2012,1,10.72468792
84,75,9,23,12.3,52,2012,1,9.969642231
43,39,4,0,11.48,65,2012,1,6.0032
13,11,2,1,11.48,61,2012,1,6.0032
16,9,7,2,10.66,52,2012,1,6.0032
5,5,0,3,10.66,56,2012,1,6.0032
2,2,0,4,10.66,56,2012,1,6.0032
17,17,0,5,9.84,52,2012,1,15.0013
64,61,3,6,8.2,59,2012,1,12.998
230,225,5,7,8.2,59,2012,1,11.0014
448,447,1,8,8.2,59,2012,1,11.0014
275,265,10,9,9.02,55,2012,1,11.0014
124,119,5,10,10.66,48,2012,1,8.9981
153,134,19,11,11.48,45,2012,1,7.0015
176,168,8,12,12.3,42,2012,1,8.9981
192,170,22,13,12.3,42,2012,1,6.0032
146,138,8,14,13.12,39,2012,1,6.0032
191,164,27,15,13.12,45,2012,1,8.9981
268,240,28,16,13.94,42,2012,1,16.9979
396,381,15,17,13.94,42,2012,1,12.998
359,345,14,18,12.3,61,2012,1,8.9981
262,246,16,19,13.12,57,2012,1,11.69752122
151,144,7,20,13.12,57,2012,1,11.69752122
122,108,14,21,13.12,66,2012,1,6.0032
113,102,11,22,13.12,66,2012,1,10.16105352
65,64,1,23,12.3,70,2012,1,6.0032
53,50,3,0,12.3,70,2012,1,8.9981
45,43,2,1,11.48,81,2012,1,8.9981
26,24,2,2,10.66,81,2012,1,12.998
9,9,0,3,9.84,87,2012,1,15.0013
4,4,0,4,9.84,87,2012,1,15.0013
2,2,0,5,9.02,93,2012,1,11.0014
9,8,1,6,9.02,93,2012,1,8.9981
19,19,0,7,9.02,93,2012,1,8.9981
78,77,1,8,9.02,93,2012,1,8.9981
90,85,5,9,9.02,93,2012,1,7.0015
166,143,23,10,9.02,93,2012,1,7.0015
183,157,26,11,9.84,81,2012,1,7.0015
221,196,25,12,10.66,81,2012,1,11.0014
235,217,18,13,10.66,81,2012,1,19.0012
243,205,38,14,10.66,81,2012,1,16.9979
124,112,12,15,12.3,61,2012,1,19.9995
146,134,12,16,9.02,75,2012,1,27.9993
144,131,13,17,9.02,69,2012,1,31.0009
108,105,3,18,9.02,47,2012,1,43.9989
87,85,2,19,8.2,40,2012,1,36.9974
63,62,1,20,6.56,43,2012,1,36.9974
48,43,5,21,5.74,43,2012,1,43.0006
46,46,0,22,5.74,39,2012,1,26.0027
20,20,0,23,4.92,50,2012,1,32.9975
21,21,0,0,4.1,68,2012,1,26.0027
24,24,0,1,3.28,79,2012,1,31.0009
27,26,1,2,4.1,58,2012,1,39.0007
14,14,0,3,4.1,46,2012,1,46.0022
1,1,0,4,4.1,46,2012,1,47.9988
3,3,0,5,4.1,49,2012,1,26.0027
2,2,0,6,4.1,49,2012,1,26.0027
18,18,0,7,3.28,53,2012,1,12.998
26,26,0,8,3.28,53,2012,1,16.9979
63,60,3,9,4.1,49,2012,1,19.9995
91,83,8,10,4.92,42,2012,1,23.9994
124,121,3,11,4.92,42,2012,1,19.9995
140,133,7,12,5.74,39,2012,1,43.0006
138,128,10,13,6.56,40,2012,1,30.0026
111,102,9,14,6.56,40,2012,1,35.0008
155,150,5,15,6.56,40,2012,1,36.9974
164,148,16,16,8.2,34,2012,1,31.0009
87,83,4,17,7.38,37,2012,1,27.9993
96,92,4,18,6.56,40,2012,1,31.0009
80,78,2,19,6.56,40,2012,1,19.0012
57,56,1,20,5.74,42,2012,1,22.0028
36,36,0,21,5.74,43,2012,1,19.9995
28,28,0,22,5.74,43,2012,1,11.0014
23,23,0,23,5.74,43,2012,1,15.0013
9,9,0,0,5.74,46,2012,1,15.0013
6,6,0,1,4.92,50,2012,1,15.0013
4,4,0,2,5.74,46,2012,1,12.998
1,1,0,3,4.92,54,2012,1,7.0015
2,2,0,4,4.92,54,2012,1,6.0032
17,17,0,5,4.1,58,2012,1,8.9981
72,71,1,6,4.1,54,2012,1,15.0013
195,194,1,7,4.1,54,2012,1,12.998
417,413,4,8,4.1,54,2012,1,8.9981
205,198,7,9,4.92,50,2012,1,12.998
71,70,1,10,5.74,50,2012,1,8.9981
90,85,5,11,9.02,37,2012,1,12.998
118,111,7,12,11.48,28,2012,1,22.0028
140,129,11,13,13.12,22,2012,1,15.0013
135,125,10,14,13.94,23,2012,1,7.0015
155,145,10,15,14.76,27,2012,1,8.9981
211,206,5,16,14.76,23,2012,1,12.998
407,399,8,17,14.76,23,2012,1,12.998
405,399,6,18,13.94,25,2012,1,16.9979
263,256,7,19,13.94,25,2012,1,8.9981
214,210,4,20,12.3,42,2012,1,11.0014
147,145,2,21,11.48,45,2012,1,8.9981
102,99,3,22,10.66,56,2012,1,7.0015
36,34,2,23,11.48,41,2012,1,10.50115375
14,14,0,0,10.66,60,2012,1,8.312045154
6,6,0,1,10.66,56,2012,1,7.960349207
3,3,0,2,11.48,41,2012,1,10.4219659
3,3,0,3,10.66,52,2012,1,10.5552357
2,2,0,4,10.66,65,2012,1,7.0015
22,20,2,5,10.66,65,2012,1,7.0015
90,89,1,6,10.66,56,2012,1,7.960349207
280,276,4,7,9.84,60,2012,1,6.0032
513,510,3,8,9.84,70,2012,1,8.901608732
262,256,6,9,10.66,56,2012,1,6.0032
98,90,8,10,10.66,60,2012,1,8.9981
112,107,5,11,12.3,45,2012,1,11.0014
172,162,10,12,12.3,52,2012,1,15.0013
173,167,6,13,14.76,40,2012,1,16.9979
124,111,13,14,16.4,40,2012,1,15.0013
145,138,7,15,17.22,38,2012,1,30.0026
266,251,15,16,17.22,35,2012,1,19.9995
523,504,19,17,17.22,38,2012,1,23.9994
406,398,8,18,15.58,46,2012,1,19.9995
281,270,11,19,14.76,50,2012,1,11.0014
184,178,6,20,15.58,46,2012,1,8.9981
109,105,4,21,14.76,50,2012,1,7.0015
77,72,5,22,14.76,50,2012,1,7.0015
57,55,2,23,14.76,50,2012,1,6.0032
22,22,0,0,13.12,57,2012,1,11.52150851
5,5,0,1,13.94,53,2012,1,10.43052394
4,4,0,2,12.3,61,2012,1,10.58412288
3,3,0,3,11.48,75,2012,1,8.919374874
1,1,0,4,11.48,70,2012,1,7.0015
25,25,0,5,11.48,70,2012,1,7.0015
95,92,3,6,12.3,61,2012,1,8.9981
321,318,3,7,12.3,65,2012,1,12.998
515,508,7,8,13.12,61,2012,1,23.9994
231,226,5,9,13.12,61,2012,1,22.0028
120,108,12,10,13.94,57,2012,1,19.9995
138,125,13,11,14.76,53,2012,1,19.0012
163,152,11,12,15.58,46,2012,1,26.0027
170,159,11,13,16.4,43,2012,1,19.0012
134,128,6,14,17.22,41,2012,1,23.9994
171,164,7,15,17.22,41,2012,1,15.0013
231,222,9,16,17.22,38,2012,1,12.998
487,470,17,17,17.22,38,2012,1,12.998
468,459,9,18,16.4,40,2012,1,15.0013
311,302,9,19,15.58,43,2012,1,11.0014
211,207,4,20,14.76,46,2012,1,11.0014
178,170,8,21,13.94,53,2012,1,11.0014
107,104,3,22,13.94,49,2012,1,7.0015
58,54,4,23,13.94,53,2012,1,6.0032
23,22,1,0,12.3,70,2012,1,8.9981
5,5,0,1,12.3,70,2012,1,9.621668598
7,6,1,2,12.3,70,2012,1,6.0032
1,1,0,3,12.3,61,2012,1,10.7299897
3,3,0,4,12.3,70,2012,1,6.0032
20,20,0,5,12.3,70,2012,1,9.621668598
87,83,4,6,12.3,70,2012,1,6.0032
288,285,3,7,12.3,70,2012,1,8.9981
498,489,9,8,12.3,70,2012,1,6.0032
202,199,3,9,12.3,70,2012,1,11.0014
44,42,2,10,13.12,70,2012,1,8.9981
71,69,2,11,13.12,70,2012,1,7.0015
45,44,1,12,13.12,76,2012,1,6.0032
64,62,2,13,13.94,71,2012,1,16.9979
31,30,1,14,13.12,81,2012,1,12.998
53,50,3,15,13.94,76,2012,1,10.6354701
118,110,8,16,13.94,81,2012,1,11.00287805
289,281,8,17,13.94,87,2012,1,10.97598626
353,345,8,18,13.94,87,2012,1,8.9981
258,254,4,19,13.12,87,2012,1,11.0014
216,211,5,20,13.12,87,2012,1,8.9981
145,142,3,21,13.94,81,2012,1,7.0015
111,108,3,22,13.12,81,2012,1,10.12618253
73,70,3,23,13.12,81,2012,1,6.0032
34,32,2,0,12.3,87,2012,1,9.717243872
18,16,2,1,12.3,93,2012,1,9.81220843
12,11,1,2,12.3,93,2012,1,7.0015
1,1,0,3,11.48,93,2012,1,7.0015
1,1,0,4,11.48,93,2012,1,12.998
16,16,0,5,11.48,93,2012,1,11.0014
71,70,1,6,11.48,96,2012,1,8.9981
226,222,4,7,11.48,93,2012,1,7.0015
520,516,4,8,10.66,100,2012,1,10.62435008
283,275,8,9,10.66,100,2012,1,10.62435008
116,103,13,10,13.94,71,2012,1,19.0012
142,133,9,11,14.76,62,2012,1,27.9993
198,177,21,12,15.58,46,2012,1,26.0027
205,171,34,13,16.4,43,2012,1,23.9994
170,137,33,14,16.4,37,2012,1,23.9994
221,180,41,15,17.22,35,2012,1,27.9993
307,251,56,16,17.22,32,2012,1,19.9995
465,429,36,17,17.22,32,2012,1,22.0028
377,362,15,18,16.4,35,2012,1,16.9979
282,266,16,19,15.58,37,2012,1,15.0013
171,158,13,20,16.4,35,2012,1,12.998
129,114,15,21,15.58,37,2012,1,12.998
107,92,15,22,14.76,40,2012,1,15.0013
82,72,10,23,14.76,40,2012,1,12.998
86,81,5,0,13.94,42,2012,1,11.0014
45,38,7,1,13.12,49,2012,1,11.0014
45,39,6,2,12.3,61,2012,1,16.9979
18,15,3,3,11.48,65,2012,1,7.0015
7,4,3,4,10.66,70,2012,1,9.216021483
1,1,0,5,9.84,70,2012,1,6.0032
9,8,1,6,9.84,70,2012,1,8.521996994
41,33,8,7,9.84,70,2012,1,8.521996994
102,92,10,8,9.02,87,2012,1,7.820223351
138,116,22,9,9.02,80,2012,1,7.0015
205,157,48,10,10.66,81,2012,1,7.0015
286,184,102,11,13.12,57,2012,1,8.9981
369,241,128,12,14.76,43,2012,1,12.998
384,219,165,13,16.4,43,2012,1,19.0012
427,244,183,14,18.04,35,2012,1,23.9994
499,270,229,15,17.22,41,2012,1,16.9979
404,218,186,16,18.04,44,2012,1,22.0028
364,222,142,17,19.68,36,2012,1,19.0012
246,176,70,18,18.86,38,2012,1,19.9995
188,150,38,19,18.04,44,2012,1,11.0014
148,123,25,20,18.04,44,2012,1,11.0014
114,89,25,21,18.04,33,2012,1,19.9995
118,101,17,22,16.4,40,2012,1,30.0026
74,62,12,23,14.76,40,2012,1,26.0027
74,65,9,0,13.94,39,2012,1,23.9994
72,62,10,1,13.12,39,2012,1,16.9979
48,45,3,2,12.3,36,2012,1,19.0012
15,12,3,3,12.3,36,2012,1,15.0013
3,3,0,4,11.48,41,2012,1,26.0027
2,1,1,5,10.66,48,2012,1,19.9995
5,5,0,6,9.84,52,2012,1,22.0028
14,12,2,7,9.84,52,2012,1,19.0012
56,48,8,8,9.84,56,2012,1,12.998
93,73,20,9,9.84,56,2012,1,16.9979
191,142,49,10,10.66,52,2012,1,16.9979
226,144,82,11,10.66,56,2012,1,22.0028
255,184,71,12,11.48,52,2012,1,16.9979
261,197,64,13,12.3,49,2012,1,11.0014
237,189,48,14,13.12,45,2012,1,12.998
253,168,85,15,12.3,49,2012,1,12.998
212,150,62,16,13.12,45,2012,1,19.0012
157,135,22,17,12.3,49,2012,1,16.9979
167,144,23,18,12.3,49,2012,1,22.0028
119,101,18,19,12.3,52,2012,1,16.9979
103,81,22,20,12.3,52,2012,1,19.0012
36,33,3,21,10.66,65,2012,1,11.0014
55,47,8,22,9.84,75,2012,1,6.0032
35,30,5,23,9.02,93,2012,1,11.0014
11,10,1,0,17.22,94,2012,1,12.34865282
12,12,0,1,18.86,94,2012,1,7.0015
6,6,0,2,18.86,94,2012,1,19.0012
3,3,0,3,18.86,94,2012,1,15.0013
5,5,0,4,19.68,88,2012,1,12.998
18,18,0,5,19.68,88,2012,1,11.0014
109,107,2,6,17.22,94,2012,1,12.34865282
304,296,8,7,18.04,94,2012,1,8.9981
594,579,15,8,17.22,94,2012,1,8.9981
286,281,5,9,18.86,77,2012,1,16.9979
133,122,11,10,21.32,55,2012,1,11.0014
168,149,19,11,22.96,43,2012,1,12.998
220,204,16,12,22.96,37,2012,1,15.0013
211,187,24,13,23.78,32,2012,1,16.9979
211,174,37,14,23.78,35,2012,1,15.0013
223,192,31,15,24.6,31,2012,1,16.9979
361,323,38,16,23.78,32,2012,1,19.9995
600,551,49,17,22.96,35,2012,1,19.9995
525,498,27,18,22.14,34,2012,1,23.9994
328,317,11,19,19.68,41,2012,1,22.0028
254,242,12,20,18.04,44,2012,1,27.9993
197,190,7,21,17.22,47,2012,1,31.0009
126,123,3,22,15.58,50,2012,1,16.9979
85,76,9,23,14.76,50,2012,1,15.0013
46,45,1,0,13.94,53,2012,1,11.0014
20,18,2,1,13.94,49,2012,1,15.0013
6,4,2,2,13.94,53,2012,1,19.0012
3,3,0,3,13.12,57,2012,1,12.998
2,2,0,4,13.12,61,2012,1,11.62680704
24,24,0,5,12.3,70,2012,1,9.731693361
92,88,4,6,12.3,70,2012,1,9.731693361
262,258,4,7,12.3,70,2012,1,9.731693361
549,533,16,8,11.48,75,2012,1,6.0032
314,299,15,9,12.3,81,2012,1,9.726488188
132,118,14,10,14.76,50,2012,1,11.0014
194,154,40,11,15.58,46,2012,1,12.998
234,194,40,12,16.4,43,2012,1,11.0014
222,191,31,13,17.22,44,2012,1,15.0013
205,176,29,14,18.04,44,2012,1,19.0012
78,73,5,15,17.22,50,2012,1,19.9995
50,49,1,16,16.4,58,2012,1,19.9995
128,123,5,17,14.76,81,2012,1,15.0013
160,154,6,18,14.76,87,2012,1,12.998
174,162,12,19,14.76,87,2012,1,12.998
100,93,7,20,14.76,87,2012,1,12.998
101,99,2,21,14.76,87,2012,1,6.0032
75,69,6,22,14.76,87,2012,1,11.43294948
23,19,4,23,14.76,87,2012,1,11.43294948
22,21,1,0,14.76,93,2012,1,6.0032
44,44,0,1,14.76,93,2012,1,13.83706978
38,34,4,2,14.76,93,2012,1,6.0032
21,20,1,3,14.76,93,2012,1,11.0014
2,2,0,4,14.76,93,2012,1,12.998
2,1,1,5,14.76,93,2012,1,6.0032
7,6,1,6,14.76,93,2012,1,6.0032
16,14,2,7,14.76,93,2012,1,8.9981
48,46,2,8,14.76,93,2012,1,13.83706978
94,87,7,9,15.58,87,2012,1,6.0032
168,137,31,10,16.4,87,2012,1,11.97132739
214,181,33,11,16.4,87,2012,1,6.0032
299,252,47,12,17.22,67,2012,1,16.9979
339,252,87,13,18.04,51,2012,1,19.0012
430,279,151,14,18.86,44,2012,1,23.9994
399,254,145,15,19.68,29,2012,1,19.9995
467,300,167,16,20.5,27,2012,1,19.9995
385,279,106,17,20.5,23,2012,1,22.0028
303,250,53,18,20.5,25,2012,1,16.9979
225,191,34,19,18.86,33,2012,1,11.0014
149,121,28,20,18.04,30,2012,1,8.9981
154,130,24,21,18.86,19,2012,1,22.0028
134,115,19,22,18.04,21,2012,1,8.9981
106,94,12,23,17.22,24,2012,1,18.63854921
72,67,5,0,16.4,30,2012,1,23.9994
76,60,16,1,15.58,34,2012,1,12.998
80,66,14,2,14.76,40,2012,1,11.0014
26,21,5,3,14.76,43,2012,1,8.9981
14,11,3,4,13.94,46,2012,1,12.998
5,5,0,5,13.94,46,2012,1,15.0013
5,5,0,6,12.3,52,2012,1,19.9995
23,21,2,7,12.3,52,2012,1,19.9995
66,54,12,8,12.3,52,2012,1,22.0028
118,104,14,9,12.3,49,2012,1,30.0026
192,161,31,10,12.3,49,2012,1,22.0028
256,192,64,11,13.12,45,2012,1,26.0027
327,256,71,12,13.94,42,2012,1,23.9994
364,256,108,13,14.76,37,2012,1,23.9994
332,226,106,14,14.76,34,2012,1,23.9994
334,252,82,15,14.76,32,2012,1,35.0008
299,231,68,16,14.76,29,2012,1,32.9975
263,214,49,17,13.94,31,2012,1,36.9974
184,164,20,18,13.12,33,2012,1,40.9973
132,120,12,19,12.3,36,2012,1,32.9975
88,80,8,20,11.48,38,2012,1,16.9979
79,70,9,21,11.48,36,2012,1,15.0013
62,53,9,22,10.66,41,2012,1,16.9979
26,24,2,23,10.66,41,2012,1,12.998
17,15,2,0,9.84,44,2012,1,12.998
6,3,3,1,9.84,48,2012,1,8.9981
4,3,1,2,9.84,48,2012,1,8.9981
1,1,0,3,9.02,51,2012,1,11.0014
1,1,0,4,8.2,55,2012,1,6.0032
18,17,1,5,8.2,55,2012,1,6.0032
91,89,2,6,7.38,59,2012,1,8.9981
260,253,7,7,7.38,59,2012,1,8.9981
428,415,13,8,8.2,59,2012,1,7.0015
197,186,11,9,9.02,60,2012,1,6.0032
86,74,12,10,9.84,60,2012,1,8.70309317
103,86,17,11,10.66,56,2012,1,8.9981
137,122,15,12,10.66,52,2012,1,10.56119829
120,109,11,13,10.66,55,2012,1,19.9995
128,115,13,14,11.48,57,2012,1,23.9994
130,110,20,15,12.3,53,2012,1,12.998
210,180,30,16,12.3,45,2012,1,19.9995
387,376,11,17,12.3,45,2012,1,19.9995
375,363,12,18,11.48,55,2012,1,43.9989
226,220,6,19,10.66,53,2012,1,15.0013
179,171,8,20,10.66,37,2012,1,31.0009
120,116,4,21,10.66,37,2012,1,26.0027
78,76,2,22,9.84,35,2012,1,22.0028
31,29,2,23,9.02,37,2012,1,39.0007
8,8,0,0,9.02,37,2012,1,19.9995
6,6,0,1,8.2,44,2012,1,16.9979
4,4,0,2,8.2,44,2012,1,15.0013
1,1,0,3,7.38,51,2012,1,19.0012
3,3,0,4,7.38,51,2012,1,19.9995
25,25,0,5,7.38,51,2012,1,15.0013
102,99,3,6,7.38,51,2012,1,7.0015
275,270,5,7,6.56,55,2012,1,8.9981
501,487,14,8,6.56,59,2012,1,7.0015
233,222,11,9,9.02,47,2012,1,9.696204628
129,113,16,10,9.84,44,2012,1,10.54640135
130,110,20,11,10.66,41,2012,1,11.0014
138,129,9,12,10.66,41,2012,1,7.0015
164,148,16,13,12.3,39,2012,1,8.9981
136,116,20,14,13.12,36,2012,1,15.0013
166,142,24,15,13.94,36,2012,1,19.9995
250,228,22,16,14.76,32,2012,1,19.0012
446,425,21,17,14.76,34,2012,1,19.0012
457,442,15,18,13.94,42,2012,1,22.0028
287,278,9,19,13.94,46,2012,1,19.9995
187,184,3,20,13.12,49,2012,1,12.998
148,143,5,21,13.12,49,2012,1,12.998
106,101,5,22,11.48,56,2012,1,11.0014
54,51,3,23,11.48,61,2012,1,15.0013
15,12,3,0,11.48,65,2012,1,19.0012
5,4,1,1,12.3,61,2012,1,19.9995
4,4,0,2,12.3,56,2012,1,19.0012
3,2,1,3,12.3,56,2012,1,23.9994
3,3,0,4,11.48,61,2012,1,22.0028
18,18,0,5,11.48,56,2012,1,19.9995
108,104,4,6,11.48,61,2012,1,26.0027
344,332,12,7,10.66,65,2012,1,26.0027
566,554,12,8,11.48,61,2012,1,19.9995
264,252,12,9,12.3,61,2012,1,22.0028
147,127,20,10,14.76,50,2012,1,19.9995
161,128,33,11,17.22,38,2012,1,19.9995
215,175,40,12,18.04,38,2012,1,26.0027
205,179,26,13,20.5,34,2012,1,27.9993
175,137,38,14,21.32,36,2012,1,22.0028
209,165,44,15,22.14,37,2012,1,30.0026
288,254,34,16,22.96,37,2012,1,27.9993
612,554,58,17,22.96,43,2012,1,32.9975
544,509,35,18,22.96,40,2012,1,31.0009
361,345,16,19,22.14,42,2012,1,23.9994
260,242,18,20,20.5,51,2012,1,16.9979
188,177,11,21,18.04,62,2012,1,16.9979
159,149,10,22,18.86,59,2012,1,19.9995
62,58,4,23,18.04,62,2012,1,22.0028
46,35,11,0,18.04,62,2012,1,22.0028
21,17,4,1,18.86,63,2012,1,22.0028
11,5,6,2,18.86,63,2012,1,26.0027
3,3,0,3,18.86,63,2012,1,26.0027
2,2,0,4,18.04,72,2012,1,19.0012
29,28,1,5,17.22,77,2012,1,15.0013
109,105,4,6,17.22,77,2012,1,16.9979
334,326,8,7,17.22,77,2012,1,23.9994
585,573,12,8,18.04,77,2012,1,26.0027
301,282,19,9,18.86,72,2012,1,31.0009
138,119,19,10,20.5,68,2012,1,31.0009
204,156,48,11,22.14,60,2012,1,31.0009
251,224,27,12,22.96,60,2012,1,30.0026
233,198,35,13,24.6,49,2012,1,43.0006
203,155,48,14,25.42,43,2012,1,43.0006
185,161,24,15,26.24,38,2012,1,46.0022
342,305,37,16,25.42,41,2012,1,43.0006
597,545,52,17,25.42,38,2012,1,43.9989
590,545,45,18,25.42,38,2012,1,36.9974
416,395,21,19,24.6,40,2012,1,30.0026
302,282,20,20,24.6,43,2012,1,26.0027
233,206,27,21,24.6,43,2012,1,26.0027
153,141,12,22,22.96,49,2012,1,22.0028
94,88,6,23,22.96,49,2012,1,30.0026
54,51,3,0,23.78,49,2012,1,31.0009
26,22,4,1,22.96,52,2012,1,32.9975
11,9,2,2,19.68,77,2012,1,27.9993
7,7,0,3,18.86,77,2012,1,35.0008
1,1,0,4,16.4,66,2012,1,19.0012
29,27,2,5,16.4,66,2012,1,19.0012
85,83,2,6,16.4,50,2012,1,23.9994
268,262,6,7,15.58,40,2012,1,19.9995
501,484,17,8,13.94,42,2012,1,35.0008
284,267,17,9,13.94,42,2012,1,35.0008
159,145,14,10,13.94,36,2012,1,32.9975
187,170,17,11,14.76,34,2012,1,23.9994
201,174,27,12,14.76,34,2012,1,27.9993
224,175,49,13,15.58,29,2012,1,26.0027
178,129,49,14,17.22,28,2012,1,31.0009
238,188,50,15,18.86,24,2012,1,16.9979
343,292,51,16,19.68,23,2012,1,27.9993
566,498,68,17,18.86,24,2012,1,26.0027
470,440,30,18,18.04,26,2012,1,35.0008
244,232,12,19,17.22,28,2012,1,40.9973
159,156,3,20,15.58,32,2012,1,23.9994
141,133,8,21,14.76,34,2012,1,22.0028
107,100,7,22,13.94,31,2012,1,32.9975
86,77,9,23,13.12,33,2012,1,19.9995
77,68,9,0,12.3,36,2012,1,23.9994
51,50,1,1,12.3,36,2012,1,16.9979
42,30,12,2,10.66,41,2012,1,16.9979
16,16,0,3,10.66,41,2012,1,19.9995
4,3,1,4,9.84,41,2012,1,23.9994
10,7,3,5,9.02,42,2012,1,19.0012
12,11,1,6,9.02,44,2012,1,19.0012
40,36,4,7,9.02,44,2012,1,16.9979
111,96,15,8,9.02,44,2012,1,19.9995
148,127,21,9,9.84,41,2012,1,22.0028
223,176,47,10,10.66,35,2012,1,27.9993
274,218,56,11,12.3,33,2012,1,22.0028
329,241,88,12,12.3,33,2012,1,22.0028
357,268,89,13,13.12,29,2012,1,19.0012
379,262,117,14,13.94,27,2012,1,19.0012
406,274,132,15,13.94,25,2012,1,8.558727935
390,275,115,16,14.76,23,2012,1,12.68393816
354,250,104,17,14.76,23,2012,1,13.72725161
297,230,67,18,14.76,21,2012,1,6.0032
184,159,25,19,13.94,25,2012,1,8.558727935
121,101,20,20,13.12,33,2012,1,8.9981
110,94,16,21,12.3,39,2012,1,15.0013
100,81,19,22,10.66,44,2012,1,11.0014
83,77,6,23,10.66,41,2012,1,12.998
69,62,7,0,10.66,44,2012,1,6.0032
61,57,4,1,9.84,52,2012,1,11.0014
66,51,15,3,9.84,60,2012,1,8.9981
22,15,7,4,9.84,60,2012,1,8.9981
7,5,2,5,9.84,60,2012,1,11.0014
10,8,2,6,9.84,70,2012,1,11.0014
17,15,2,7,9.02,69,2012,1,8.9981
72,68,4,8,9.02,69,2012,1,8.9981
90,70,20,9,10.66,60,2012,1,15.0013
218,147,71,10,13.12,49,2012,1,19.0012
299,209,90,11,14.76,43,2012,1,19.0012
410,264,146,12,16.4,37,2012,1,19.9995
464,288,176,13,17.22,41,2012,1,19.9995
501,289,212,14,18.86,31,2012,1,19.0012
487,286,201,15,20.5,29,2012,1,19.9995
509,301,208,16,20.5,31,2012,1,23.9994
498,299,199,17,21.32,27,2012,1,19.9995
389,256,133,18,21.32,29,2012,1,19.0012
258,203,55,19,20.5,31,2012,1,19.0012
171,129,42,20,18.04,47,2012,1,15.0013
147,110,37,21,17.22,54,2012,1,15.0013
94,81,13,22,16.4,54,2012,1,12.998
52,40,12,23,16.4,50,2012,1,11.0014
24,20,4,0,15.58,54,2012,1,12.998
10,9,1,1,15.58,50,2012,1,8.9981
9,5,4,2,15.58,54,2012,1,7.0015
2,2,0,3,14.76,50,2012,1,8.9981
3,3,0,4,13.94,61,2012,1,12.998
16,15,1,5,13.94,61,2012,1,12.998
88,86,2,6,13.94,57,2012,1,7.0015
268,259,9,7,13.94,53,2012,1,7.0015
564,547,17,8,13.94,61,2012,1,8.9981
281,260,21,9,15.58,54,2012,1,11.0014
137,98,39,10,16.4,50,2012,1,15.0013
150,111,39,11,18.04,44,2012,1,15.0013
221,162,59,12,19.68,39,2012,1,15.0013
250,176,74,13,22.14,32,2012,1,16.9979
221,145,76,14,23.78,32,2012,1,19.0012
233,159,74,15,22.96,40,2012,1,8.9981
332,255,77,16,25.42,35,2012,1,30.0026
644,557,87,17,25.42,38,2012,1,27.9993
712,623,89,18,24.6,43,2012,1,12.998
446,379,67,19,22.96,49,2012,1,15.0013
286,237,49,20,22.96,49,2012,1,15.0013
205,183,22,21,22.14,56,2012,1,15.0013
133,116,17,22,22.96,56,2012,1,15.0013
63,53,10,23,22.96,56,2012,1,15.0013
26,21,5,0,22.96,52,2012,1,12.998
16,14,2,1,21.32,59,2012,1,15.0013
1,1,0,2,21.32,72,2012,1,19.9995
2,2,0,3,21.32,72,2012,1,19.9995
1,1,0,4,18.86,82,2012,1,12.998
24,24,0,5,18.86,82,2012,1,12.998
113,108,5,6,18.86,82,2012,1,12.998
308,292,16,7,18.86,82,2012,1,19.0012
593,571,22,8,18.86,82,2012,1,19.0012
342,324,18,9,19.68,82,2012,1,19.0012
143,115,28,10,21.32,77,2012,1,15.0013
219,155,64,11,22.14,73,2012,1,19.0012
244,197,47,12,24.6,60,2012,1,19.0012
233,180,53,13,24.6,60,2012,1,26.0027
212,160,52,14,26.24,53,2012,1,22.0028
264,196,68,15,28.7,39,2012,1,15.0013
365,312,53,16,29.52,34,2012,1,26.0027
676,614,62,17,28.7,37,2012,1,7.0015
734,638,96,18,28.7,34,2012,1,19.9995
479,429,50,19,26.24,47,2012,1,15.0013
351,306,45,20,24.6,49,2012,1,11.0014
244,200,44,21,23.78,56,2012,1,7.0015
170,146,24,22,22.96,60,2012,1,6.0032
87,79,8,23,22.96,56,2012,1,8.9981
39,34,5,0,22.14,60,2012,1,7.0015
27,25,2,1,21.32,63,2012,1,6.0032
2,2,0,2,20.5,68,2012,1,12.998
4,3,1,3,19.68,72,2012,1,12.998
5,4,1,4,19.68,67,2012,1,6.0032
27,25,2,5,18.04,82,2012,1,8.9981
121,120,1,6,18.04,82,2012,1,6.0032
368,348,20,7,18.04,82,2012,1,7.0015
662,628,34,8,18.04,82,2012,1,11.89794516
351,325,26,9,21.32,68,2012,1,12.45218967
188,150,38,10,22.96,56,2012,1,7.0015
220,155,65,11,25.42,41,2012,1,11.0014
267,212,55,12,26.24,29,2012,1,21.6615677
254,197,57,13,27.06,27,2012,1,15.0013
224,163,61,14,28.7,23,2012,1,22.0028
283,197,86,15,28.7,24,2012,1,21.17315661
356,278,78,16,29.52,25,2012,1,12.998
472,402,70,19,26.24,33,2012,1,11.0014
330,286,44,20,25.42,35,2012,1,7.0015
288,241,47,21,24.6,40,2012,1,6.0032
202,159,43,22,21.32,55,2012,1,8.9981
91,72,19,23,22.96,43,2012,1,11.0014
60,46,14,0,22.14,49,2012,1,8.9981
23,8,15,1,20.5,59,2012,1,7.0015
19,5,14,2,20.5,59,2012,1,14.62837619
7,7,0,3,20.5,63,2012,1,14.52870532
14,3,11,4,18.04,77,2012,1,7.0015
26,24,2,5,18.86,67,2012,1,13.06916646
117,113,4,6,18.04,72,2012,1,6.0032
381,367,14,7,18.04,72,2012,1,6.0032
623,602,21,8,18.04,77,2012,1,7.0015
315,285,30,9,19.68,77,2012,1,6.0032
164,130,34,10,21.32,68,2012,1,7.0015
211,151,60,11,22.96,60,2012,1,8.9981
265,206,59,12,25.42,50,2012,1,8.9981
273,211,62,13,27.06,41,2012,1,6.0032
258,177,81,14,29.52,30,2012,1,7.0015
287,187,100,15,29.52,32,2012,1,15.0013
426,331,95,16,29.52,37,2012,1,26.0027
713,634,79,17,28.7,39,2012,1,16.9979
425,353,72,19,26.24,50,2012,1,12.998
330,270,60,20,23.78,60,2012,1,23.9994
243,207,36,21,22.14,68,2012,1,19.0012
169,137,32,22,21.32,68,2012,1,8.9981
97,85,12,23,19.68,72,2012,1,12.998
57,49,8,0,18.04,77,2012,1,16.9979
26,22,4,1,17.22,82,2012,1,22.0028
4,4,0,2,17.22,82,2012,1,12.998
3,3,0,3,16.4,87,2012,1,19.0012
3,3,0,4,16.4,87,2012,1,16.9979
32,30,2,5,16.4,87,2012,1,15.0013
99,96,3,6,16.4,87,2012,1,11.0014
278,265,13,7,16.4,87,2012,1,12.998
562,534,28,8,16.4,87,2012,1,15.0013
312,277,35,9,17.22,82,2012,1,12.08492161
180,136,44,10,16.4,87,2012,1,6.0032
207,167,40,11,18.04,77,2012,1,12.87178763
294,222,72,12,18.04,82,2012,1,8.9981
260,208,52,13,18.86,77,2012,1,6.0032
202,146,56,14,19.68,72,2012,1,12.93473219
107,88,19,15,18.86,82,2012,1,7.0015
129,111,18,16,19.68,77,2012,1,16.5861476
258,235,23,17,19.68,82,2012,1,6.0032
408,377,31,18,19.68,82,2012,1,6.0032
296,273,23,19,18.86,88,2012,1,11.53391306
235,204,31,20,18.86,88,2012,1,11.36125944
152,144,8,21,18.04,94,2012,1,12.08820556
148,132,16,22,18.04,94,2012,1,12.08820556
126,104,22,23,18.04,94,2012,1,12.08820556
100,87,13,0,18.04,94,2012,1,6.0032
69,57,12,1,18.04,94,2012,1,12.08820556
42,32,10,2,18.04,88,2012,1,11.52037978
26,24,2,3,18.04,88,2012,1,11.52037978
2,2,0,4,17.22,94,2012,1,12.34865282
8,3,5,5,17.22,94,2012,1,6.0032
30,29,1,6,17.22,94,2012,1,12.998
86,57,29,7,16.4,100,2012,1,8.9981
218,155,63,8,17.22,94,2012,1,7.0015
321,217,104,9,18.04,88,2012,1,6.0032
443,303,140,10,20.5,77,2012,1,6.0032
585,359,226,11,21.32,77,2012,1,8.9981
651,365,286,12,22.96,68,2012,1,11.0014
686,400,286,13,24.6,60,2012,1,7.0015
690,338,352,14,25.42,53,2012,1,6.0032
679,322,357,15,26.24,53,2012,1,8.9981
685,318,367,16,26.24,50,2012,1,16.18858023
648,357,291,17,26.24,50,2012,1,8.9981
560,339,221,18,25.42,57,2012,1,19.9995
417,262,155,19,23.78,64,2012,1,19.0012
271,182,89,20,22.96,64,2012,1,12.998
223,169,54,21,22.14,68,2012,1,11.0014
211,153,58,22,22.14,68,2012,1,12.55529646
185,151,34,23,20.5,77,2012,1,11.0014
107,80,27,0,18.86,88,2012,1,12.998
113,88,25,1,18.86,82,2012,1,8.9981
56,41,15,2,18.86,82,2012,1,7.0015
18,15,3,3,18.04,88,2012,1,8.9981
14,8,6,4,17.22,94,2012,1,11.0014
6,6,0,5,16.4,94,2012,1,7.0015
11,9,2,6,16.4,94,2012,1,7.0015
42,25,17,7,17.22,88,2012,1,11.0014
96,71,25,8,17.22,88,2012,1,7.0015
178,113,65,9,17.22,88,2012,1,6.0032
351,212,139,10,17.22,88,2012,1,7.0015
368,239,129,11,18.04,82,2012,1,11.0014
503,281,222,12,18.04,88,2012,1,8.9981
544,346,198,13,18.86,82,2012,1,11.0014
521,303,218,14,20.5,77,2012,1,6.0032
554,314,240,15,22.14,68,2012,1,6.0032
541,312,229,16,22.14,73,2012,1,6.0032
541,308,233,17,22.96,64,2012,1,6.0032
459,294,165,18,22.96,64,2012,1,11.0014
352,234,118,19,22.96,64,2012,1,11.0014
198,139,59,20,21.32,77,2012,1,8.9981
173,129,44,21,21.32,72,2012,1,6.0032
100,79,21,22,20.5,77,2012,1,7.0015
46,39,7,23,19.68,82,2012,1,11.0014
23,19,4,0,19.68,82,2012,1,7.0015
15,15,0,1,18.86,88,2012,1,7.0015
8,7,1,2,18.86,88,2012,1,11.0014
2,2,0,3,18.86,88,2012,1,6.0032
3,3,0,4,18.04,94,2012,1,11.60120878
31,31,0,5,18.04,94,2012,1,11.60120878
120,118,2,6,18.86,88,2012,1,8.9981
354,329,25,7,18.86,88,2012,1,12.998
579,563,16,8,18.86,88,2012,1,7.0015
331,276,55,9,20.5,72,2012,1,11.0014
184,128,56,10,21.32,72,2012,1,8.9981
201,145,56,11,22.96,68,2012,1,11.0014
282,211,71,12,24.6,64,2012,1,16.9979
263,194,69,13,25.42,61,2012,1,16.9979
260,200,60,14,26.24,57,2012,1,12.998
286,189,97,15,26.24,57,2012,1,15.0013
385,320,65,16,27.06,50,2012,1,15.0013
721,615,106,17,26.24,53,2012,1,15.0013
549,463,86,19,25.42,61,2012,1,15.0013
330,296,34,20,24.6,64,2012,1,15.0013
223,190,33,21,24.6,64,2012,1,11.0014
148,131,17,22,22.96,73,2012,1,11.0014
54,45,9,23,22.96,78,2012,1,8.9981
67,59,8,0,14.76,76,2012,2,16.9979
62,49,13,1,14.76,76,2012,2,11.0014
81,61,20,2,14.76,76,2012,2,11.0014
25,21,4,3,13.94,81,2012,2,8.9981
12,9,3,4,13.94,81,2012,2,6.0032
18,10,8,5,13.94,81,2012,2,6.0032
97,88,9,6,14.76,76,2012,2,8.9981
84,55,29,7,14.76,71,2012,2,8.9981
125,88,37,8,14.76,76,2012,2,6.0032
275,173,102,9,14.76,81,2012,2,8.9981
360,228,132,10,16.4,71,2012,2,7.0015
451,271,180,11,16.4,71,2012,2,12.998
445,258,187,12,17.22,67,2012,2,15.0013
464,274,190,13,18.04,62,2012,2,12.998
561,278,283,14,19.68,55,2012,2,15.0013
573,278,295,15,20.5,55,2012,2,16.9979
511,275,236,16,21.32,52,2012,2,16.9979
555,323,232,17,21.32,55,2012,2,19.0012
432,279,153,18,21.32,52,2012,2,19.9995
346,236,110,19,21.32,55,2012,2,15.0013
232,166,66,20,20.5,59,2012,2,15.0013
134,101,33,21,20.5,59,2012,2,11.0014
68,61,7,22,20.5,63,2012,2,7.0015
63,53,10,23,18.86,72,2012,2,16.15340627
17,11,6,0,18.04,82,2012,2,7.0015
5,5,0,1,17.22,88,2012,2,6.0032
5,3,2,2,18.04,94,2012,2,8.9981
4,2,2,4,16.4,76,2012,2,32.9975
24,22,2,5,16.4,76,2012,2,32.9975
110,104,6,6,14.76,71,2012,2,31.0009
306,294,12,7,13.94,66,2012,2,26.0027
589,553,36,8,14.76,57,2012,2,22.0028
317,265,52,9,15.58,54,2012,2,23.9994
204,119,85,10,16.4,50,2012,2,35.0008
209,128,81,11,17.22,47,2012,2,30.0026
281,181,100,12,18.04,44,2012,2,30.0026
281,184,97,13,18.86,36,2012,2,19.9995
268,141,127,14,18.86,31,2012,2,27.9993
324,192,132,15,19.68,33,2012,2,27.9993
395,291,104,16,20.5,34,2012,2,22.0028
729,601,128,17,20.5,29,2012,2,19.0012
618,543,75,18,20.5,27,2012,2,16.9979
494,428,66,19,20.5,27,2012,2,16.9979
329,281,48,20,18.86,31,2012,2,11.0014
238,214,24,21,18.86,28,2012,2,8.9981
123,106,17,22,17.22,44,2012,2,12.998
66,60,6,23,18.04,35,2012,2,11.0014
33,32,1,0,16.4,43,2012,2,8.9981
11,11,0,1,15.58,46,2012,2,15.0013
5,5,0,2,14.76,53,2012,2,11.0014
3,3,0,3,15.58,46,2012,2,17.70974681
1,1,0,4,13.12,66,2012,2,6.0032
27,25,2,5,13.12,66,2012,2,6.0032
100,98,2,6,12.3,61,2012,2,6.0032
341,327,14,7,13.12,66,2012,2,6.0032
604,577,27,8,13.94,57,2012,2,12.52725275
408,354,54,9,17.22,38,2012,2,6.0032
219,142,77,10,18.04,33,2012,2,18.11589812
258,167,91,11,19.68,23,2012,2,20.86021565
331,230,101,12,21.32,25,2012,2,20.83536066
345,225,120,13,22.96,19,2012,2,16.9979
311,191,120,14,22.96,21,2012,2,15.0013
316,207,109,15,24.6,20,2012,2,12.998
485,340,145,16,25.42,21,2012,2,11.0014
558,460,98,19,22.96,26,2012,2,7.0015
379,325,54,20,22.96,24,2012,2,8.9981
243,210,33,21,22.14,45,2012,2,16.63935568
158,133,25,22,20.5,51,2012,2,16.12229911
79,66,13,23,20.5,59,2012,2,14.53922806
41,23,18,0,19.68,48,2012,2,16.77714261
11,11,0,1,18.86,59,2012,2,14.54514716
5,5,0,2,18.86,51,2012,2,16.5870543
3,3,0,3,18.04,58,2012,2,6.0032
1,1,0,4,17.22,67,2012,2,6.0032
27,27,0,5,17.22,67,2012,2,6.0032
126,120,6,6,17.22,58,2012,2,14.7888154
366,354,12,7,18.04,62,2012,2,14.83298447
684,653,31,8,18.04,72,2012,2,7.0015
363,316,47,9,19.68,55,2012,2,8.9981
167,99,68,10,22.14,45,2012,2,8.9981
213,152,61,11,24.6,43,2012,2,23.9994
283,210,73,12,24.6,46,2012,2,27.9993
251,181,70,13,24.6,46,2012,2,16.9979
258,176,82,14,25.42,46,2012,2,12.998
268,182,86,15,26.24,44,2012,2,19.0012
390,304,86,16,26.24,44,2012,2,19.0012
494,419,75,19,27.06,39,2012,2,15.0013
372,333,39,20,26.24,27,2012,2,15.0013
298,255,43,21,24.6,23,2012,2,22.0028
181,151,30,22,22.96,22,2012,2,11.0014
131,112,19,23,21.32,23,2012,2,27.9993
45,33,12,0,21.32,23,2012,2,27.9993
13,9,4,1,19.68,27,2012,2,22.0028
18,11,7,2,18.86,33,2012,2,30.0026
5,5,0,3,17.22,41,2012,2,19.9995
1,1,0,4,15.58,43,2012,2,19.0012
29,28,1,5,15.58,43,2012,2,19.0012
126,118,8,6,14.76,46,2012,2,22.0028
354,339,15,7,13.94,49,2012,2,12.998
638,610,28,8,14.76,46,2012,2,15.0013
351,290,61,9,16.4,37,2012,2,16.9979
246,158,88,10,17.22,35,2012,2,19.0012
268,159,109,11,17.22,38,2012,2,15.0013
276,210,66,12,18.04,33,2012,2,18.11589812
291,202,89,13,18.86,31,2012,2,19.33716043
287,144,143,14,18.86,33,2012,2,11.0014
269,171,98,15,20.5,31,2012,2,7.0015
402,318,84,16,20.5,31,2012,2,12.998
698,618,80,18,20.5,31,2012,2,7.0015
487,423,64,19,19.68,31,2012,2,16.9979
312,279,33,20,18.04,41,2012,2,12.998
234,209,25,21,17.22,47,2012,2,12.998
149,129,20,22,16.4,47,2012,2,12.998
136,124,12,23,16.4,50,2012,2,8.9981
61,49,12,0,16.4,43,2012,2,17.84149291
38,28,10,1,14.76,62,2012,2,8.9981
11,5,6,2,14.76,50,2012,2,26.0027
8,5,3,3,13.94,53,2012,2,22.0028
5,3,2,4,13.94,49,2012,2,16.9979
23,23,0,5,13.12,53,2012,2,22.0028
80,80,0,6,12.3,49,2012,2,26.0027
246,231,15,7,12.3,49,2012,2,19.0012
508,489,19,8,12.3,49,2012,2,22.0028
376,318,58,9,13.94,42,2012,2,22.0028
238,157,81,10,14.76,40,2012,2,22.0028
291,179,112,11,16.4,37,2012,2,19.9995
337,224,113,12,17.22,35,2012,2,19.9995
411,238,173,13,18.04,33,2012,2,22.0028
490,250,240,14,19.68,29,2012,2,26.0027
537,319,218,15,20.5,27,2012,2,19.0012
536,352,184,16,20.5,22,2012,2,27.9993
655,483,172,17,21.32,23,2012,2,27.9993
484,380,104,18,20.5,22,2012,2,31.0009
412,297,115,19,19.68,23,2012,2,19.9995
252,191,61,20,18.86,24,2012,2,19.0012
190,136,54,21,18.04,26,2012,2,8.9981
158,124,34,22,16.4,35,2012,2,15.0013
113,92,21,23,17.22,30,2012,2,19.0012
94,85,9,0,17.22,26,2012,2,19.9995
69,60,9,1,16.4,28,2012,2,16.9979
36,25,11,2,14.76,29,2012,2,23.9994
28,21,7,3,14.76,32,2012,2,16.9979
7,4,3,4,13.12,36,2012,2,11.0014
2,2,0,5,13.12,33,2012,2,11.0014
19,18,1,6,13.12,36,2012,2,12.998
54,40,14,7,13.12,33,2012,2,19.0012
123,94,29,8,13.94,34,2012,2,16.9979
276,173,103,9,16.4,30,2012,2,16.9979
363,176,187,10,17.22,28,2012,2,16.9979
495,244,251,11,18.04,24,2012,2,19.9995
590,270,320,12,18.86,23,2012,2,26.0027
643,288,355,13,20.5,22,2012,2,12.998
578,252,326,14,20.5,22,2012,2,19.9995
626,305,321,15,21.32,19,2012,2,27.9993
615,261,354,16,22.14,19,2012,2,26.0027
567,268,299,17,22.14,19,2012,2,27.9993
517,290,227,18,22.14,18,2012,2,19.9995
413,243,170,19,22.14,16,2012,2,22.0028
208,135,73,20,20.5,20,2012,2,15.0013
234,159,75,21,20.5,20,2012,2,12.998
182,106,76,22,19.68,20,2012,2,12.998
118,86,32,23,18.86,23,2012,2,15.0013
85,64,21,0,18.04,24,2012,2,15.0013
64,50,14,1,18.04,24,2012,2,15.0013
32,25,7,2,18.04,24,2012,2,15.0013
26,18,8,3,17.22,26,2012,2,8.9981
7,7,0,4,16.4,40,2012,2,17.96811301
12,8,4,5,15.58,46,2012,2,17.70974681
28,21,7,6,14.76,37,2012,2,15.04875006
37,25,12,7,15.58,27,2012,2,11.0014
84,65,19,8,16.4,30,2012,2,12.998
179,108,71,9,18.04,26,2012,2,15.0013
299,186,113,10,20.5,25,2012,2,15.0013
404,209,195,11,20.5,25,2012,2,19.0012
457,259,198,12,22.14,24,2012,2,16.9979
483,254,229,13,23.78,23,2012,2,11.0014
503,249,254,14,24.6,18,2012,2,30.0026
486,226,260,15,25.42,17,2012,2,23.9994
476,244,232,16,26.24,19,2012,2,22.0028
411,226,185,17,25.42,22,2012,2,19.9995
310,159,151,18,25.42,25,2012,2,22.0028
276,187,89,19,24.6,23,2012,2,26.0027
211,146,65,20,22.96,28,2012,2,27.9993
130,77,53,21,21.32,34,2012,2,15.0013
118,85,33,22,20.5,36,2012,2,15.0013
51,41,10,23,20.5,39,2012,2,16.9979
37,29,8,0,19.68,39,2012,2,19.0012
16,12,4,1,18.86,41,2012,2,8.9981
6,4,2,2,18.86,31,2012,2,12.998
3,3,0,3,18.04,30,2012,2,11.0014
5,3,2,4,18.04,24,2012,2,12.998
32,30,2,5,18.04,24,2012,2,12.998
111,108,3,6,17.22,26,2012,2,15.0013
331,320,11,7,17.22,28,2012,2,12.998
617,595,22,8,18.04,30,2012,2,12.998
286,236,50,9,18.86,31,2012,2,23.9994
178,113,65,10,20.5,27,2012,2,32.9975
223,127,96,11,21.32,27,2012,2,27.9993
280,186,94,12,22.14,28,2012,2,47.9988
281,173,108,13,22.14,28,2012,2,39.0007
218,152,66,14,22.96,28,2012,2,36.9974
255,173,82,15,23.78,28,2012,2,36.9974
391,310,81,16,22.96,30,2012,2,27.9993
632,565,67,17,22.14,32,2012,2,27.9993
646,586,60,18,22.14,34,2012,2,19.9995
421,386,35,19,21.32,34,2012,2,23.9994
276,255,21,20,20.5,36,2012,2,30.0026
165,151,14,21,19.68,41,2012,2,27.9993
108,102,6,22,18.86,41,2012,2,32.9975
67,61,6,23,18.04,44,2012,2,19.9995
26,23,3,0,18.04,47,2012,2,19.0012
9,9,0,1,17.22,50,2012,2,15.0013
2,2,0,2,14.76,71,2012,2,8.9981
2,2,0,3,14.76,71,2012,2,8.9981
2,2,0,4,13.94,71,2012,2,8.9981
24,24,0,5,13.94,71,2012,2,8.9981
103,100,3,6,13.94,71,2012,2,7.0015
384,368,16,7,13.94,71,2012,2,7.0015
692,670,22,8,15.58,62,2012,2,8.9981
319,303,16,9,17.22,67,2012,2,12.998
181,132,49,10,18.86,47,2012,2,11.0014
239,161,78,11,20.5,36,2012,2,19.76536787
259,184,75,12,22.14,22,2012,2,19.0012
283,202,81,13,21.32,23,2012,2,11.0014
224,149,75,14,22.14,24,2012,2,12.998
203,157,46,15,22.96,21,2012,2,19.9995
362,296,66,16,23.78,21,2012,2,16.9979
704,626,78,18,22.14,22,2012,2,27.9993
479,428,51,19,21.32,20,2012,2,23.9994
282,248,34,20,18.86,28,2012,2,26.0027
206,191,15,21,18.04,30,2012,2,30.0026
127,118,9,22,16.4,37,2012,2,32.9975
62,48,14,23,14.76,40,2012,2,27.9993
30,22,8,0,13.94,36,2012,2,27.9993
12,9,3,1,13.94,39,2012,2,19.0012
2,2,0,2,13.12,45,2012,2,19.0012
2,2,0,3,12.3,49,2012,2,15.0013
27,26,1,5,11.48,56,2012,2,12.998
106,103,3,6,11.48,56,2012,2,7.0015
321,303,18,7,11.48,52,2012,2,8.9981
595,581,14,8,12.3,49,2012,2,15.0013
302,282,20,9,13.12,49,2012,2,19.9995
153,127,26,10,13.94,49,2012,2,22.0028
180,142,38,11,15.58,43,2012,2,22.0028
182,147,35,12,14.76,46,2012,2,26.0027
163,147,16,13,16.4,40,2012,2,23.9994
135,101,34,14,14.76,57,2012,2,12.998
202,152,50,15,15.58,46,2012,2,15.0013
307,256,51,16,18.04,33,2012,2,19.9995
579,527,52,17,17.22,35,2012,2,26.0027
585,546,39,18,16.4,43,2012,2,27.9993
384,356,28,19,16.4,40,2012,2,23.9994
235,213,22,20,14.76,46,2012,2,22.0028
165,154,11,21,13.94,57,2012,2,26.0027
134,130,4,22,13.94,57,2012,2,22.0028
61,52,9,23,13.94,57,2012,2,19.9995
23,22,1,0,13.12,66,2012,2,19.0012
9,7,2,1,13.12,66,2012,2,15.0013
4,4,0,2,13.12,61,2012,2,19.0012
5,3,2,3,13.12,61,2012,2,16.9979
1,1,0,4,12.3,61,2012,2,15.0013
21,21,0,5,12.3,61,2012,2,15.0013
96,94,2,6,12.3,65,2012,2,16.9979
306,294,12,7,12.3,65,2012,2,22.0028
624,604,20,8,13.12,66,2012,2,22.0028
287,271,16,9,14.76,57,2012,2,23.9994
141,103,38,10,16.4,50,2012,2,19.9995
224,174,50,11,17.22,47,2012,2,19.9995
259,199,60,12,18.86,41,2012,2,30.0026
203,148,55,13,19.68,36,2012,2,30.0026
224,150,74,14,20.5,31,2012,2,22.0028
211,169,42,15,19.68,31,2012,2,16.9979
353,299,54,16,19.68,31,2012,2,19.0012
656,596,60,17,20.5,27,2012,2,26.0027
610,547,63,18,20.5,27,2012,2,26.0027
433,383,50,19,18.86,31,2012,2,19.9995
280,254,26,20,18.04,33,2012,2,16.9979
187,174,13,21,17.22,35,2012,2,8.9981
158,143,15,22,17.22,35,2012,2,12.998
94,86,8,23,17.22,35,2012,2,12.998
55,41,14,0,16.4,37,2012,2,16.9979
30,28,2,1,14.76,46,2012,2,12.998
11,5,6,2,13.94,49,2012,2,12.998
11,8,3,3,13.94,61,2012,2,11.0014
5,4,1,4,13.94,53,2012,2,8.9981
21,19,2,5,13.94,53,2012,2,11.0014
84,84,0,6,13.12,57,2012,2,11.0014
296,283,13,7,13.94,61,2012,2,15.0013
563,539,24,8,15.58,46,2012,2,11.0014
330,294,36,9,17.22,41,2012,2,11.0014
192,133,59,10,18.04,38,2012,2,12.998
233,158,75,11,18.86,36,2012,2,8.9981
322,218,104,12,20.5,31,2012,2,19.69055691
358,246,112,13,21.32,27,2012,2,19.0012
348,223,125,14,21.32,27,2012,2,21.35020211
352,237,115,15,22.14,28,2012,2,16.9979
463,350,113,16,22.96,26,2012,2,16.9979
671,564,107,18,22.14,26,2012,2,8.9981
427,352,75,19,22.14,24,2012,2,11.0014
286,242,44,20,20.5,29,2012,2,8.9981
189,153,36,21,20.5,36,2012,2,19.76536787
215,181,34,22,18.04,62,2012,2,7.0015
198,163,35,23,17.22,62,2012,2,6.0032
96,85,11,0,16.4,58,2012,2,8.9981
70,60,10,1,16.4,58,2012,2,8.9981
56,53,3,2,15.58,66,2012,2,8.9981
32,26,6,3,14.76,66,2012,2,6.0032
14,9,5,4,14.76,71,2012,2,7.0015
7,5,2,5,14.76,66,2012,2,7.0015
21,19,2,6,13.94,76,2012,2,11.0014
64,56,8,7,14.76,71,2012,2,7.0015
160,136,24,8,14.76,71,2012,2,8.9981
265,206,59,9,17.22,54,2012,2,8.9981
406,267,139,10,18.86,51,2012,2,11.0014
564,357,207,11,21.32,45,2012,2,12.998
678,404,274,12,23.78,35,2012,2,16.9979
678,370,308,13,25.42,33,2012,2,19.9995
660,372,288,14,26.24,27,2012,2,30.0026
658,347,311,15,26.24,27,2012,2,23.9994
582,329,253,16,26.24,27,2012,2,23.9994
560,309,251,17,25.42,33,2012,2,16.9979
481,284,197,18,25.42,35,2012,2,15.0013
459,296,163,19,24.6,40,2012,2,11.0014
321,209,112,20,22.96,46,2012,2,8.9981
220,167,53,21,22.96,43,2012,2,8.9981
212,148,64,22,22.14,52,2012,2,11.0014
196,151,45,23,22.14,56,2012,2,12.998
124,94,30,0,22.14,56,2012,2,12.998
106,89,17,1,22.14,56,2012,2,11.0014
74,54,20,2,22.14,56,2012,2,7.0015
45,27,18,3,21.32,59,2012,2,8.9981
12,10,2,4,22.14,52,2012,2,15.87885289
10,6,4,5,20.5,68,2012,2,11.0014
16,11,5,6,20.5,63,2012,2,8.9981
46,30,16,7,20.5,63,2012,2,7.0015
97,64,33,8,21.32,59,2012,2,14.45801709
251,154,97,9,22.14,56,2012,2,15.0013
421,235,186,10,23.78,53,2012,2,15.0013
528,301,227,11,25.42,46,2012,2,19.9995
635,360,275,12,26.24,44,2012,2,19.0012
681,383,298,13,27.06,44,2012,2,19.0012
628,346,282,14,28.7,39,2012,2,19.0012
617,351,266,15,28.7,39,2012,2,26.0027
616,330,286,16,29.52,39,2012,2,23.9994
623,361,262,17,28.7,42,2012,2,22.0028
479,295,184,18,28.7,42,2012,2,16.9979
379,265,114,19,28.7,42,2012,2,16.9979
291,205,86,20,26.24,50,2012,2,15.0013
229,153,76,21,25.42,57,2012,2,16.9979
134,97,37,22,27.88,44,2012,2,23.9994
90,65,25,23,27.06,50,2012,2,26.0027
41,26,15,0,26.24,53,2012,2,22.0028
28,21,7,1,25.42,61,2012,2,23.9994
14,9,5,2,24.6,64,2012,2,16.9979
8,5,3,3,23.78,68,2012,2,12.998
6,6,0,4,22.14,77,2012,2,15.0013
38,34,4,5,22.14,77,2012,2,15.0013
133,123,10,6,21.32,83,2012,2,11.0014
387,367,20,7,21.32,83,2012,2,8.9981
597,549,48,8,22.96,83,2012,2,11.0014
297,238,59,9,25.42,69,2012,2,15.0013
224,149,75,10,25.42,69,2012,2,16.9979
251,136,115,11,26.24,65,2012,2,16.9979
271,196,75,12,27.88,57,2012,2,16.9979
263,184,79,13,30.34,45,2012,2,19.9995
288,183,105,14,31.16,45,2012,2,22.0028
275,194,81,15,32.8,33,2012,2,30.0026
358,266,92,16,32.8,33,2012,2,31.0009
712,601,111,17,32.8,33,2012,2,26.0027
676,589,87,18,32.8,31,2012,2,26.0027
522,461,61,19,31.16,35,2012,2,26.0027
375,327,48,20,30.34,37,2012,2,19.9995
271,232,39,21,27.88,51,2012,2,16.9979
214,179,35,22,27.88,51,2012,2,16.9979
121,97,24,23,28.7,45,2012,2,19.9995
43,33,10,0,27.06,54,2012,2,12.998
11,5,6,1,26.24,57,2012,2,11.0014
4,3,1,2,22.96,83,2012,2,7.0015
6,6,0,3,22.96,83,2012,2,6.0032
9,6,3,4,27.06,44,2012,2,15.0013
30,29,1,5,24.6,53,2012,2,16.9979
144,136,8,6,24.6,46,2012,2,16.9979
461,443,18,7,24.6,43,2012,2,16.9979
673,631,42,8,24.6,43,2012,2,15.0013
400,329,71,9,24.6,38,2012,2,32.9975
217,165,52,10,24.6,38,2012,2,27.9993
239,174,65,11,24.6,33,2012,2,27.9993
244,179,65,12,24.6,33,2012,2,23.9994
239,187,52,13,25.42,29,2012,2,16.9979
257,198,59,14,26.24,27,2012,2,19.0012
308,217,91,15,27.06,24,2012,2,22.0028
370,320,50,16,27.88,22,2012,2,23.9994
537,464,73,19,24.6,26,2012,2,16.9979
402,358,44,20,24.6,23,2012,2,19.0012
297,260,37,21,22.96,26,2012,2,19.9995
162,144,18,22,22.14,30,2012,2,16.9979
82,72,10,23,22.14,32,2012,2,15.0013
38,35,3,0,22.14,32,2012,2,11.0014
14,13,1,1,21.32,34,2012,2,12.998
9,8,1,2,20.5,42,2012,2,12.998
6,6,0,3,20.5,42,2012,2,15.0013
7,7,0,4,20.5,42,2012,2,19.0012
34,34,0,5,20.5,39,2012,2,19.0012
134,128,6,6,20.5,39,2012,2,19.0012
418,408,10,7,20.5,39,2012,2,12.998
576,551,25,8,20.5,39,2012,2,12.998
265,245,20,9,19.68,44,2012,2,19.9995
147,116,31,10,19.68,47,2012,2,15.0013
119,105,14,11,18.86,47,2012,2,16.9979
110,95,15,12,18.86,51,2012,2,7.0015
64,51,13,13,18.86,59,2012,2,16.45984482
51,43,8,14,18.04,72,2012,2,7.0015
98,88,10,15,17.22,77,2012,2,12.998
235,199,36,16,17.22,77,2012,2,15.0013
488,442,46,17,17.22,77,2012,2,12.998
505,478,27,18,17.22,77,2012,2,12.6838072
368,342,26,19,17.22,77,2012,2,8.9981
260,252,8,20,17.22,77,2012,2,7.0015
189,165,24,21,17.22,82,2012,2,6.0032
162,153,9,22,17.22,77,2012,2,6.0032
70,56,14,23,17.22,77,2012,2,12.6838072
25,20,5,0,17.22,77,2012,2,16.0308068
13,11,2,1,17.22,77,2012,2,7.0015
6,4,2,2,17.22,77,2012,2,12.6838072
4,3,1,3,17.22,77,2012,2,12.6838072
4,4,0,4,17.22,71,2012,2,12.8805901
30,30,0,5,16.4,82,2012,2,12.20246335
120,116,4,6,16.4,82,2012,2,7.0015
406,391,15,7,16.4,82,2012,2,8.9981
677,651,26,8,17.22,82,2012,2,7.0015
301,270,31,9,18.86,72,2012,2,13.42251273
189,143,46,10,19.68,63,2012,2,6.0032
229,183,46,11,21.32,48,2012,2,16.5664849
264,213,51,12,22.14,49,2012,2,16.60025585
238,186,52,13,22.96,46,2012,2,16.59841127
237,183,54,14,23.78,43,2012,2,16.9485935
262,196,66,15,24.6,43,2012,2,17.07348309
387,324,63,16,25.42,41,2012,2,7.0015
586,516,70,19,23.78,46,2012,2,8.9981
404,352,52,20,22.96,49,2012,2,15.0013
267,240,27,21,21.32,55,2012,2,7.0015
248,219,29,22,21.32,59,2012,2,12.998
144,124,20,23,20.5,63,2012,2,7.0015
35,28,7,0,20.5,59,2012,2,12.998
21,21,0,1,20.5,63,2012,2,8.9981
8,7,1,2,20.5,72,2012,2,6.0032
3,2,1,3,20.5,77,2012,2,12.21290064
8,7,1,4,21.32,72,2012,2,6.0032
17,17,0,5,21.32,72,2012,2,6.0032
26,24,2,6,21.32,77,2012,2,7.0015
169,161,8,7,20.5,94,2012,2,16.9979
557,538,19,8,21.32,94,2012,2,19.0012
349,331,18,9,22.14,88,2012,2,12.998
174,144,30,10,25.42,78,2012,2,16.9979
229,179,50,11,27.06,65,2012,2,19.0012
269,228,41,12,28.7,58,2012,2,15.0013
249,208,41,13,29.52,51,2012,2,15.0013
204,167,37,14,30.34,48,2012,2,16.9979
234,186,48,15,30.34,45,2012,2,15.0013
354,313,41,16,30.34,45,2012,2,12.998
681,616,65,17,30.34,48,2012,2,6.0032
487,429,58,19,28.7,54,2012,2,8.9981
335,299,36,20,27.06,61,2012,2,11.0014
282,251,31,21,26.24,65,2012,2,8.9981
211,190,21,22,26.24,65,2012,2,12.3463929
95,79,16,23,24.6,78,2012,2,11.0780979
47,43,4,0,24.6,78,2012,2,7.0015
15,7,8,1,22.96,83,2012,2,10.85944356
16,9,7,2,22.96,83,2012,2,10.85944356
6,6,0,3,22.96,83,2012,2,6.0032
4,2,2,4,22.14,88,2012,2,10.32448832
33,31,2,5,22.14,90,2012,2,8.9981
120,117,3,6,22.96,84,2012,2,15.02932631
358,344,14,7,22.14,88,2012,2,12.998
666,640,26,8,22.96,88,2012,2,11.18837392
315,289,26,9,22.96,88,2012,2,11.18837392
175,147,28,10,23.78,83,2012,2,7.0015
184,145,39,11,23.78,81,2012,2,8.9981
245,210,35,12,23.78,83,2012,2,15.0013
228,179,49,13,23.78,78,2012,2,12.998
240,189,51,14,25.42,69,2012,2,6.0032
256,204,52,15,26.24,65,2012,2,12.998
367,313,54,16,26.24,65,2012,2,11.0014
729,659,70,17,24.6,73,2012,2,16.9979
504,461,43,19,22.14,77,2012,2,16.9979
338,296,42,20,21.32,77,2012,2,16.9979
239,218,21,21,21.32,77,2012,2,15.0013
173,146,27,22,20.5,82,2012,2,15.0013
98,77,21,23,20.5,77,2012,2,16.9979
90,75,15,0,19.68,82,2012,2,15.0013
24,15,9,1,18.86,88,2012,2,7.0015
17,13,4,2,18.86,88,2012,2,8.9981
6,4,2,3,18.86,88,2012,2,11.02221156
2,2,0,4,18.86,88,2012,2,16.9979
21,20,1,5,18.86,88,2012,2,16.9979
136,128,8,6,18.86,88,2012,2,11.0014
384,376,8,7,18.04,94,2012,2,7.0015
627,608,19,8,18.86,88,2012,2,12.998
304,279,25,9,19.68,88,2012,2,7.0015
168,132,36,10,21.32,77,2012,2,12.2228721
201,167,34,11,22.14,77,2012,2,11.64836984
301,237,64,12,22.96,73,2012,2,8.9981
265,217,48,13,24.6,69,2012,2,12.998
204,171,33,14,26.24,65,2012,2,12.998
283,220,63,15,27.06,61,2012,2,12.998
370,325,45,16,27.88,57,2012,2,11.0014
704,617,87,17,29.52,54,2012,2,8.9981
706,642,64,18,29.52,58,2012,2,8.9981
522,467,55,19,28.7,61,2012,2,12.998
420,368,52,20,26.24,73,2012,2,12.998
299,257,42,21,25.42,78,2012,2,8.9981
246,217,29,22,25.42,78,2012,2,10.9870646
121,100,21,23,24.6,83,2012,2,10.70477696
89,70,19,0,24.6,78,2012,2,22.0028
48,33,15,1,24.6,78,2012,2,7.0015
11,11,0,2,23.78,83,2012,2,8.9981
14,14,0,3,22.96,88,2012,2,15.0013
4,4,0,4,22.96,88,2012,2,12.998
24,24,0,5,22.96,88,2012,2,12.998
135,127,8,6,22.14,94,2012,2,7.0015
356,347,9,7,22.96,88,2012,2,10.31105688
618,584,34,8,22.96,88,2012,2,10.31105688
294,262,32,9,24.6,78,2012,2,11.0780979
199,154,45,10,25.42,73,2012,2,8.9981
258,181,77,11,28.7,61,2012,2,15.29978585
171,125,46,12,25.42,78,2012,2,23.9994
278,207,71,13,26.24,73,2012,2,13.68295718
242,159,83,14,27.06,74,2012,2,19.0012
343,240,103,15,29.52,62,2012,2,7.0015
440,358,82,16,31.16,48,2012,2,11.0014
643,547,96,17,28.7,54,2012,2,31.0009
641,564,77,18,28.7,54,2012,2,31.0009
452,388,64,19,28.7,51,2012,2,8.9981
313,255,58,20,27.88,51,2012,2,7.0015
235,186,49,21,26.24,69,2012,2,12.998
232,182,50,22,24.6,83,2012,2,8.9981
256,205,51,23,24.6,83,2012,2,6.0032
153,111,42,0,24.6,83,2012,2,10.70477696
107,79,28,1,24.6,83,2012,2,10.70477696
75,51,24,2,23.78,88,2012,2,10.28808934
32,21,11,3,23.78,83,2012,2,10.84878342
9,9,0,4,22.96,88,2012,2,7.0015
22,14,8,5,22.96,88,2012,2,6.0032
42,33,9,6,22.14,94,2012,2,11.43305771
87,79,8,7,22.96,88,2012,2,10.31105688
197,155,42,8,23.78,83,2012,2,6.0032
284,223,61,9,25.42,78,2012,2,7.0015
432,284,148,10,27.06,65,2012,2,8.9981
575,354,221,11,28.7,58,2012,2,6.0032
550,330,220,12,29.52,58,2012,2,7.0015
524,307,217,13,30.34,55,2012,2,8.9981
428,241,187,14,28.7,61,2012,2,19.9995
541,300,241,15,27.06,74,2012,2,12.998
540,310,230,16,27.88,65,2012,2,26.0027
502,298,204,17,27.88,65,2012,2,19.9995
434,278,156,18,27.06,69,2012,2,23.9994
405,254,151,19,25.42,73,2012,2,22.0028
309,209,100,20,24.6,78,2012,2,16.9979
269,183,86,21,23.78,78,2012,2,15.0013
217,150,67,22,23.78,78,2012,2,12.998
149,114,35,23,22.96,83,2012,2,19.0012
134,111,23,0,22.96,83,2012,2,8.9981
121,84,37,1,22.14,83,2012,2,15.0013
93,64,29,2,22.14,83,2012,2,19.0012
28,19,9,3,22.14,83,2012,2,12.998
16,7,9,4,21.32,83,2012,2,11.0014
11,10,1,5,21.32,83,2012,2,11.0014
17,14,3,6,21.32,83,2012,2,15.0013
36,31,5,7,21.32,83,2012,2,11.0014
114,91,23,8,20.5,88,2012,2,8.9981
191,128,63,9,21.32,83,2012,2,11.0014
333,221,112,10,22.14,77,2012,2,7.0015
414,270,144,11,22.96,73,2012,2,7.0015
558,351,207,12,24.6,64,2012,2,6.0032
565,368,197,13,24.6,64,2012,2,14.41390783
518,292,226,14,24.6,64,2012,2,7.0015
571,342,229,15,25.42,61,2012,2,7.0015
544,363,181,16,25.42,61,2012,2,14.55620919
511,316,195,17,25.42,65,2012,2,8.9981
463,332,131,18,25.42,61,2012,2,12.998
383,266,117,19,24.6,64,2012,2,11.0014
276,203,73,20,24.6,64,2012,2,12.998
203,148,55,21,22.96,73,2012,2,12.998
157,113,44,22,22.96,73,2012,2,11.0014
102,80,22,23,21.32,77,2012,2,12.998
34,21,13,0,21.32,77,2012,2,8.9981
9,8,1,1,21.32,77,2012,2,12.998
6,5,1,2,20.5,77,2012,2,12.998
5,3,2,3,20.5,77,2012,2,12.998
2,2,0,4,18.86,88,2012,2,8.9981
23,21,2,5,18.86,88,2012,2,7.0015
142,134,8,6,18.86,88,2012,2,7.0015
385,367,18,7,19.68,82,2012,2,7.0015
639,608,31,8,20.5,82,2012,2,12.998
350,289,61,9,20.5,82,2012,2,15.0013
190,128,62,10,21.32,77,2012,2,12.998
213,149,64,11,22.14,73,2012,2,12.998
263,189,74,12,22.96,68,2012,2,15.0013
272,197,75,13,24.6,53,2012,2,22.0028
239,180,59,14,25.42,50,2012,2,23.9994
262,186,76,15,25.42,53,2012,2,19.9995
388,320,68,16,24.6,53,2012,2,26.0027
680,602,78,18,24.6,53,2012,2,23.9994
546,463,83,19,23.78,56,2012,2,22.0028
323,277,46,20,22.14,52,2012,2,19.0012
247,210,37,21,22.14,45,2012,2,15.0013
173,147,26,22,22.14,45,2012,2,16.9979
113,92,21,23,22.14,45,2012,2,12.998
38,28,10,0,21.32,52,2012,2,16.9979
9,3,6,1,21.32,59,2012,2,15.0013
16,7,9,2,21.32,63,2012,2,19.9995
6,4,2,3,21.32,68,2012,2,19.0012
5,5,0,4,21.32,68,2012,2,22.0028
20,20,0,5,21.32,72,2012,2,19.0012
165,158,7,6,20.5,77,2012,2,19.9995
463,442,21,7,21.32,72,2012,2,19.0012
641,605,36,8,22.14,73,2012,2,19.9995
295,258,37,9,22.96,68,2012,2,23.9994
157,111,46,10,23.78,68,2012,2,27.9993
217,157,60,11,24.6,64,2012,2,26.0027
263,203,60,12,25.42,65,2012,2,22.0028
219,166,53,13,26.24,65,2012,2,16.9979
71,63,8,14,25.42,69,2012,2,22.0028
134,94,40,15,25.42,73,2012,2,16.9979
389,335,54,16,26.24,73,2012,2,15.0013
717,640,77,17,26.24,69,2012,2,19.0012
710,641,69,18,26.24,69,2012,2,19.0012
458,399,59,19,26.24,69,2012,2,19.0012
302,262,40,20,26.24,69,2012,2,19.0012
223,202,21,21,26.24,65,2012,2,19.0012
147,134,13,22,24.6,78,2012,2,16.9979
63,53,10,23,24.6,78,2012,2,22.0028
35,27,8,0,23.78,83,2012,2,12.998
14,11,3,1,24.6,78,2012,2,16.9979
1,1,0,2,22.96,88,2012,2,30.0026
2,2,0,3,22.96,88,2012,2,11.0014
5,5,0,4,22.96,88,2012,2,15.0013
28,27,1,5,22.96,88,2012,2,8.9981
126,121,5,6,22.96,88,2012,2,7.0015
418,401,17,7,22.96,94,2012,2,12.998
622,594,28,8,24.6,83,2012,2,8.9981
325,285,40,9,24.6,83,2012,2,11.23150713
153,113,40,10,25.42,65,2012,2,16.9979
201,156,45,11,25.42,59,2012,2,19.9995
280,222,58,12,25.42,57,2012,2,15.0013
266,216,50,13,26.24,53,2012,2,16.9979
243,175,68,14,26.24,53,2012,2,16.9979
259,191,68,15,26.24,53,2012,2,7.0015
357,289,68,16,27.06,50,2012,2,12.998
705,629,76,17,26.24,53,2012,2,8.9981
372,349,23,18,21.32,77,2012,2,39.0007
98,96,2,19,20.5,77,2012,2,23.9994
51,48,3,20,20.5,82,2012,2,15.0013
34,30,4,21,20.5,82,2012,2,11.0014
67,62,5,22,19.68,82,2012,2,7.0015
55,47,8,23,19.68,82,2012,2,12.998
33,31,2,0,20.5,77,2012,2,11.0014
11,9,2,1,19.68,88,2012,2,8.9981
3,3,0,2,19.68,88,2012,2,7.0015
3,3,0,3,18.86,88,2012,2,15.0013
2,2,0,4,18.86,77,2012,2,12.998
24,23,1,5,18.86,72,2012,2,19.9995
139,130,9,6,18.04,72,2012,2,15.0013
401,393,8,7,18.04,72,2012,2,19.9995
630,603,27,8,18.86,67,2012,2,23.9994
361,299,62,9,20.5,59,2012,2,31.0009
154,112,42,10,20.5,51,2012,2,27.9993
256,179,77,11,21.32,48,2012,2,35.0008
272,207,65,12,21.32,48,2012,2,27.9993
318,228,90,13,22.14,39,2012,2,30.0026
247,186,61,14,22.96,37,2012,2,27.9993
271,192,79,15,22.14,37,2012,2,26.0027
421,334,87,16,23.78,30,2012,2,31.0009
732,648,84,17,24.6,31,2012,2,26.0027
553,469,84,19,22.14,37,2012,2,23.9994
374,315,59,20,21.32,40,2012,2,22.0028
230,211,19,21,20.5,42,2012,2,12.998
232,196,36,22,20.5,42,2012,2,7.0015
135,112,23,23,19.68,48,2012,2,7.0015
64,47,17,0,18.86,55,2012,2,7.0015
46,32,14,1,18.86,51,2012,2,8.9981
31,16,15,2,18.86,44,2012,2,11.0014
13,8,5,3,18.86,41,2012,2,19.0012
9,6,3,4,17.22,50,2012,2,12.998
26,23,3,5,17.22,47,2012,2,11.0014
135,128,7,6,17.22,50,2012,2,16.9979
351,345,6,7,17.22,50,2012,2,16.9979
620,579,41,8,18.86,44,2012,2,16.9979
322,288,34,9,19.68,41,2012,2,19.9995
210,141,69,10,21.32,36,2012,2,22.0028
291,203,88,11,22.96,35,2012,2,16.9979
348,259,89,12,22.96,28,2012,2,27.9993
363,263,100,13,24.6,26,2012,2,26.0027
334,218,116,14,25.42,23,2012,2,15.0013
439,299,140,15,25.42,25,2012,2,12.998
525,397,128,16,25.42,25,2012,2,22.0028
596,518,78,18,26.24,23,2012,2,19.0012
503,430,73,19,26.24,23,2012,2,16.9979
341,277,64,20,25.42,25,2012,2,8.9981
270,225,45,21,24.6,28,2012,2,7.0015
234,190,44,22,22.96,35,2012,2,15.0013
180,142,38,23,22.14,37,2012,2,12.998
136,111,25,0,21.32,42,2012,2,11.0014
93,79,14,1,20.5,48,2012,2,15.72225548
56,46,10,2,18.86,59,2012,2,8.9981
34,20,14,3,19.68,59,2012,2,14.22482469
9,6,3,4,18.04,67,2012,2,7.0015
13,8,5,5,17.22,67,2012,2,8.9981
33,23,10,6,17.22,67,2012,2,6.0032
67,57,10,7,17.22,71,2012,2,8.9981
178,156,22,8,21.32,48,2012,2,15.69999879
335,248,87,9,22.14,49,2012,2,15.81073157
411,279,132,10,22.96,49,2012,2,6.0032
522,365,157,11,25.42,41,2012,2,6.0032
559,353,206,12,26.24,36,2012,2,11.0014
659,366,293,13,26.24,36,2012,2,12.998
615,358,257,14,27.06,36,2012,2,12.998
590,321,269,15,27.88,24,2012,2,12.998
591,337,254,16,28.7,21,2012,2,12.998
576,343,233,17,27.06,36,2012,2,12.998
546,382,164,18,27.06,31,2012,2,12.998
439,273,166,19,26.24,36,2012,2,11.0014
287,174,113,20,25.42,46,2012,2,11.0014
230,156,74,21,24.6,60,2012,2,8.9981
274,212,62,22,22.96,68,2012,2,8.9981
176,134,42,23,23.78,56,2012,2,6.0032
98,79,19,0,22.96,64,2012,2,11.0014
94,72,22,1,22.14,68,2012,2,8.9981
82,60,22,2,22.14,68,2012,2,11.0014
28,26,2,3,22.14,64,2012,2,8.9981
9,7,2,4,22.14,68,2012,2,12.998
12,8,4,5,21.32,72,2012,2,12.998
21,15,6,6,21.32,68,2012,2,11.0014
60,42,18,7,21.32,68,2012,2,11.0014
156,124,32,8,22.96,64,2012,2,11.0014
222,143,79,9,24.6,56,2012,2,8.9981
350,222,128,10,24.6,60,2012,2,16.9979
428,278,150,11,25.42,57,2012,2,16.9979
531,342,189,12,26.24,57,2012,2,15.0013
602,347,255,13,27.88,54,2012,2,16.9979
552,324,228,14,28.7,48,2012,2,8.9981
499,309,190,15,29.52,45,2012,2,23.9994
564,339,225,16,29.52,42,2012,2,16.9979
478,287,191,17,28.7,45,2012,2,27.9993
389,260,129,18,27.88,44,2012,2,23.9994
339,232,107,19,27.06,50,2012,2,27.9993
230,163,67,20,27.06,50,2012,2,19.0012
169,121,48,21,26.24,53,2012,2,12.998
131,89,42,22,25.42,61,2012,2,11.0014
74,57,17,23,25.42,57,2012,2,15.0013
35,14,21,0,24.6,56,2012,2,16.9979
11,6,5,1,24.6,60,2012,2,19.0012
2,1,1,2,24.6,60,2012,2,19.9995
2,2,0,3,23.78,68,2012,2,22.0028
6,3,3,4,22.14,77,2012,2,15.0013
26,25,1,5,22.14,77,2012,2,11.0014
65,62,3,6,21.32,94,2012,2,19.9995
75,72,3,7,21.32,94,2012,2,12.998
156,155,1,8,22.14,88,2012,2,15.0013
110,105,5,9,22.14,88,2012,2,19.0012
59,53,6,10,22.14,88,2012,2,16.9979
79,67,12,11,22.96,83,2012,2,15.0013
185,132,53,12,22.96,88,2012,2,19.0012
176,143,33,13,25.42,73,2012,2,15.0013
171,128,43,14,25.42,73,2012,2,16.9979
196,156,40,15,25.42,73,2012,2,11.0014
111,91,20,16,25.42,69,2012,2,19.0012
229,204,25,17,22.96,88,2012,2,16.9979
300,283,17,18,23.78,83,2012,2,11.38110388
304,294,10,19,23.78,88,2012,2,8.9981
189,178,11,20,23.78,88,2012,2,12.998
152,145,7,21,23.78,83,2012,2,6.0032
129,118,11,22,23.78,78,2012,2,6.0032
75,64,11,23,23.78,78,2012,2,7.0015
32,25,7,0,22.96,88,2012,2,8.9981
19,14,5,1,22.96,88,2012,2,8.9981
4,3,1,2,22.96,88,2012,2,8.9981
6,5,1,3,23.78,83,2012,2,8.9981
5,4,1,4,22.96,94,2012,2,13.7686448
8,8,0,5,22.96,94,2012,2,15.0013
24,22,2,6,22.96,94,2012,2,15.0013
92,91,1,7,22.96,94,2012,2,8.9981
409,401,8,8,23.78,88,2012,2,6.0032
355,327,28,9,23.78,88,2012,2,6.0032
171,144,27,10,25.42,78,2012,2,7.0015
224,186,38,11,26.24,78,2012,2,12.998
264,220,44,12,26.24,73,2012,2,12.998
239,204,35,13,26.24,73,2012,2,12.998
184,145,39,14,26.24,73,2012,2,12.998
256,205,51,15,28.7,61,2012,2,6.0032
374,300,74,16,27.88,65,2012,2,11.0014
678,603,75,17,27.88,65,2012,2,7.0015
733,665,68,18,28.7,61,2012,2,6.0032
512,455,57,19,27.06,69,2012,2,11.0014
263,233,30,20,26.24,73,2012,2,8.9981
109,98,11,21,26.24,73,2012,2,19.0012
83,74,9,22,23.78,78,2012,2,15.0013
71,58,13,23,22.96,88,2012,2,7.0015
39,27,12,0,23.78,88,2012,2,10.90643062
21,14,7,1,23.78,88,2012,2,8.9981
19,14,5,2,22.96,94,2012,2,12.998
6,5,1,3,22.96,88,2012,2,7.0015
4,3,1,4,22.14,94,2012,2,8.9981
38,34,4,5,22.14,94,2012,2,7.0015
158,150,8,6,22.14,94,2012,2,6.0032
440,426,14,7,22.96,83,2012,2,10.85944356
650,617,33,8,23.78,83,2012,2,10.84878342
347,314,33,9,24.6,78,2012,2,8.9981
192,149,43,10,27.06,61,2012,2,14.18326972
267,212,55,11,28.7,54,2012,2,8.9981
330,271,59,12,28.7,54,2012,2,12.998
350,273,77,13,29.52,42,2012,2,14.32899593
263,221,42,14,29.52,42,2012,2,6.0032
274,222,52,15,29.52,48,2012,2,7.0015
446,376,70,16,29.52,45,2012,2,7.0015
590,499,91,19,28.7,54,2012,2,19.0012
459,398,61,20,27.06,65,2012,2,16.9979
393,330,63,21,26.24,73,2012,2,12.998
286,253,33,22,26.24,73,2012,2,11.0014
133,107,26,23,25.42,78,2012,2,7.0015
79,49,30,0,24.6,78,2012,2,8.9981
28,16,12,1,24.6,83,2012,2,11.0014
16,8,8,2,24.6,78,2012,2,11.0014
3,3,0,3,24.6,73,2012,2,16.9979
16,13,3,4,24.6,64,2012,2,22.0028
35,34,1,5,22.96,68,2012,2,22.0028
159,149,10,6,22.14,73,2012,2,23.9994
474,449,25,7,22.14,73,2012,2,26.0027
634,605,29,8,21.32,55,2012,2,30.0026
346,289,57,9,22.14,52,2012,2,27.9993
205,162,43,10,22.96,52,2012,2,16.9979
279,202,77,11,23.78,49,2012,2,15.0013
348,276,72,12,24.6,43,2012,2,12.998
327,241,86,13,25.42,41,2012,2,12.998
270,202,68,14,26.24,38,2012,2,12.998
316,233,83,15,26.24,36,2012,2,16.9979
430,344,86,16,27.06,31,2012,2,12.998
537,451,86,19,26.24,31,2012,2,12.998
446,363,83,20,24.6,40,2012,2,12.998
299,254,45,21,23.78,40,2012,2,7.0015
251,209,42,22,22.96,43,2012,2,6.0032
166,137,29,23,22.14,49,2012,2,8.9981
70,57,13,0,21.32,59,2012,2,7.0015
49,33,16,1,20.5,59,2012,2,6.0032
21,9,12,2,19.68,67,2012,2,8.9981
14,8,6,3,18.86,72,2012,2,6.0032
11,11,0,4,18.86,77,2012,2,11.0014
34,33,1,5,18.86,77,2012,2,7.0015
182,168,14,6,18.04,77,2012,2,8.9981
515,475,40,7,18.86,82,2012,2,7.0015
361,304,57,9,22.96,56,2012,2,7.0015
255,181,74,10,24.6,46,2012,2,8.9981
334,225,109,11,25.42,43,2012,2,15.26853129
360,252,108,12,25.42,41,2012,2,12.998
395,297,98,13,26.24,36,2012,2,11.0014
350,242,108,14,27.06,34,2012,2,8.9981
391,260,131,15,27.06,36,2012,2,12.998
568,417,151,16,27.06,34,2012,2,16.9979
669,570,99,18,26.24,38,2012,2,15.0013
483,392,91,19,25.42,41,2012,2,12.998
337,264,73,20,25.42,41,2012,2,11.0014
258,209,49,21,24.6,40,2012,2,16.37565516
251,194,57,22,22.96,52,2012,2,22.0028
174,133,41,23,21.32,55,2012,2,14.5759033
148,118,30,0,21.32,48,2012,2,7.0015
104,84,20,1,20.5,48,2012,2,15.72225548
69,56,13,2,20.5,51,2012,2,7.0015
33,23,10,3,20.5,48,2012,2,7.0015
14,8,6,4,19.68,59,2012,2,6.0032
12,11,1,5,18.86,67,2012,2,11.87994634
50,38,12,6,18.04,72,2012,2,6.0032
95,67,28,7,18.86,67,2012,2,7.0015
195,162,33,8,21.32,52,2012,2,11.0014
292,213,79,9,22.96,43,2012,2,11.0014
452,275,177,10,22.96,43,2012,2,15.49559661
586,351,235,11,25.42,38,2012,2,6.0032
642,366,276,12,27.06,36,2012,2,16.01436062
704,372,332,13,28.7,37,2012,2,8.9981
730,369,361,14,29.52,30,2012,2,6.0032
672,316,356,15,29.52,30,2012,2,7.0015
642,311,331,16,30.34,30,2012,2,7.0015
626,347,279,17,30.34,30,2012,2,6.0032
645,391,254,18,30.34,33,2012,2,6.0032
432,229,203,19,28.7,39,2012,2,8.9981
315,197,118,20,27.88,41,2012,2,6.0032
259,178,81,21,26.24,50,2012,2,14.63238498
338,234,104,22,26.24,47,2012,2,14.62147476
239,168,71,23,24.6,56,2012,2,11.0014
86,76,10,0,27.06,50,2012,2,16.9979
34,34,0,1,26.24,53,2012,2,15.0013
16,13,3,2,26.24,57,2012,2,15.0013
4,4,0,3,25.42,73,2012,2,6.0032
6,5,1,4,25.42,73,2012,2,6.0032
45,41,4,5,25.42,78,2012,2,6.0032
141,136,5,6,25.42,88,2012,2,8.9981
402,369,33,7,26.24,89,2012,2,12.998
694,675,19,8,26.24,89,2012,2,12.998
298,274,24,9,26.24,83,2012,2,15.0013
204,155,49,10,27.06,78,2012,2,19.0012
235,193,42,11,28.7,74,2012,2,19.0012
310,238,72,12,28.7,74,2012,2,23.9994
316,240,76,13,29.52,70,2012,2,19.9995
254,199,55,14,29.52,66,2012,2,19.0012
258,213,45,15,29.52,66,2012,2,19.0012
222,186,36,16,30.34,58,2012,2,30.0026
227,202,25,17,28.7,70,2012,2,16.9979
110,100,10,18,25.42,88,2012,2,23.9994
45,41,4,19,25.42,88,2012,2,23.9994
39,38,1,20,25.42,94,2012,2,16.9979
85,73,12,21,26.24,78,2012,2,16.9979
23,22,1,22,24.6,88,2012,2,8.9981
73,67,6,23,24.6,88,2012,2,8.9981
86,81,5,0,22.96,83,2012,2,8.9981
76,61,15,1,22.96,83,2012,2,7.0015
41,38,3,2,22.14,88,2012,2,11.51768078
26,18,8,3,22.96,73,2012,2,16.9979
13,11,2,4,22.14,68,2012,2,19.0012
12,11,1,5,20.5,72,2012,2,12.998
36,31,5,6,20.5,77,2012,2,12.998
86,77,9,7,21.32,72,2012,2,7.0015
210,180,30,8,22.14,64,2012,2,11.0014
332,243,89,9,22.96,60,2012,2,16.9979
493,348,145,10,24.6,53,2012,2,19.9995
536,357,179,11,23.78,46,2012,2,19.0012
668,418,250,12,25.42,43,2012,2,23.9994
679,400,279,13,25.42,41,2012,2,16.9979
647,388,259,14,26.24,38,2012,2,19.9995
702,405,297,15,26.24,38,2012,2,16.9979
644,369,275,16,26.24,38,2012,2,16.9979
586,338,248,17,26.24,36,2012,2,16.66288119
512,341,171,18,26.24,36,2012,2,16.66288119
554,369,185,19,26.24,36,2012,2,11.0014
399,260,139,20,25.42,35,2012,2,19.0012
316,220,96,21,24.6,40,2012,2,7.0015
228,176,52,22,23.78,46,2012,2,8.9981
238,185,53,23,22.96,52,2012,2,7.0015
169,142,27,0,22.14,60,2012,2,11.0014
121,100,21,1,22.14,56,2012,2,8.9981
89,67,22,2,21.32,59,2012,2,7.0015
50,34,16,3,21.32,63,2012,2,7.0015
13,12,1,4,20.5,72,2012,2,6.0032
12,11,1,5,20.5,68,2012,2,10.87830354
22,16,6,6,18.86,82,2012,2,7.0015
35,29,6,7,20.5,68,2012,2,7.0015
140,110,30,8,22.14,60,2012,2,6.0032
300,230,70,9,24.6,46,2012,2,12.998
404,277,127,10,25.42,43,2012,2,15.0013
511,312,199,11,26.24,41,2012,2,16.9979
684,408,276,12,27.06,39,2012,2,19.9995
686,421,265,13,27.88,36,2012,2,19.0012
678,411,267,14,27.88,36,2012,2,22.0028
644,408,236,15,28.7,34,2012,2,16.36907846
662,436,226,16,28.7,34,2012,2,19.9995
578,386,192,17,28.7,34,2012,2,16.9979
496,343,153,18,28.7,34,2012,2,16.9979
453,337,116,19,27.88,34,2012,2,19.0012
314,230,84,20,27.06,39,2012,2,12.998
246,180,66,21,25.42,43,2012,2,11.0014
226,165,61,22,25.42,50,2012,2,26.0027
108,82,26,23,23.78,53,2012,2,7.0015
49,38,11,0,23.78,53,2012,2,14.93336719
14,10,4,1,22.96,60,2012,2,11.0014
11,10,1,2,22.96,60,2012,2,15.0013
5,5,0,3,22.96,60,2012,2,11.0014
8,6,2,4,22.14,64,2012,2,6.0032
35,33,2,5,21.32,68,2012,2,10.97198516
139,135,4,6,21.32,68,2012,2,10.97198516
517,504,13,7,22.96,60,2012,2,15.0013
665,643,22,8,24.6,49,2012,2,15.0013
282,244,38,9,25.42,43,2012,2,19.0012
187,120,67,10,26.24,41,2012,2,31.0009
239,168,71,11,26.24,38,2012,2,32.9975
282,220,62,12,26.24,41,2012,2,30.0026
274,189,85,13,26.24,41,2012,2,23.9994
270,186,84,14,25.42,41,2012,2,32.9975
292,215,77,15,27.06,39,2012,2,19.9995
448,375,73,16,27.06,39,2012,2,31.0009
645,554,91,19,25.42,38,2012,2,27.9993
461,390,71,20,24.6,40,2012,2,23.9994
265,225,40,21,23.78,49,2012,2,16.9979
168,127,41,22,22.96,52,2012,2,19.0012
86,78,8,23,23.78,49,2012,2,19.9995
34,28,6,0,22.14,68,2012,2,27.9993
20,18,2,1,21.32,77,2012,2,22.0028
8,8,0,2,21.32,72,2012,2,19.9995
5,5,0,3,20.5,82,2012,2,12.998
5,4,1,4,20.5,82,2012,2,12.998
36,35,1,5,19.68,82,2012,2,11.0014
184,177,7,6,19.68,82,2012,2,16.9979
569,540,29,7,19.68,77,2012,2,19.9995
710,680,30,8,19.68,77,2012,2,15.0013
335,285,50,9,21.32,72,2012,2,16.9979
176,118,58,10,21.32,63,2012,2,19.9995
227,162,65,11,22.96,56,2012,2,12.998
247,202,45,12,22.14,56,2012,2,15.0013
267,201,66,13,24.6,46,2012,2,11.0014
276,194,82,14,23.78,46,2012,2,11.0014
272,218,54,15,23.78,46,2012,2,8.9981
473,382,91,16,24.6,43,2012,2,12.998
513,445,68,19,23.78,46,2012,2,16.9979
415,371,44,20,22.96,49,2012,2,15.0013
283,253,30,21,22.14,56,2012,2,11.0014
193,171,22,22,22.96,52,2012,2,7.0015
113,93,20,23,22.14,56,2012,2,6.0032
49,46,3,0,21.32,59,2012,2,6.0032
27,21,6,1,21.32,68,2012,2,10.97198516
11,7,4,2,20.5,68,2012,2,10.87830354
8,8,0,3,18.86,82,2012,2,10.29747443
10,7,3,4,18.86,82,2012,2,7.0015
38,37,1,5,19.68,77,2012,2,10.78445814
172,165,7,6,19.68,77,2012,2,10.78445814
547,531,16,7,20.5,72,2012,2,10.53719281
668,637,31,8,22.14,68,2012,2,11.69311983
303,268,35,9,22.96,60,2012,2,6.0032
203,148,55,10,24.6,46,2012,2,6.0032
226,161,65,11,25.42,43,2012,2,6.0032
315,235,80,12,25.42,38,2012,2,16.82811576
303,230,73,13,25.42,41,2012,2,6.0032
302,191,111,14,26.24,38,2012,2,16.64043636
300,225,75,15,26.24,38,2012,2,16.64043636
452,345,107,16,26.24,41,2012,2,8.9981
724,652,72,17,25.42,43,2012,2,8.9981
538,486,52,19,22.96,73,2012,2,19.9995
408,349,59,20,22.14,73,2012,2,19.0012
298,260,38,21,22.14,73,2012,2,11.0014
248,221,27,22,21.32,77,2012,2,6.0032
123,110,13,23,21.32,77,2012,2,10.73845811
59,50,9,0,21.32,77,2012,2,8.9981
22,17,5,1,21.32,77,2012,2,11.0014
12,12,0,2,21.32,77,2012,2,6.0032
5,5,0,3,20.5,77,2012,2,7.0015
6,6,0,4,18.86,88,2012,2,7.0015
34,34,0,5,19.68,82,2012,2,6.0032
170,165,5,6,18.86,88,2012,2,7.0015
526,506,20,7,20.5,82,2012,2,11.0014
681,661,20,8,21.32,77,2012,2,10.73845811
337,300,37,9,23.78,68,2012,2,11.63607567
210,154,56,10,24.6,64,2012,2,6.0032
237,170,67,11,27.06,47,2012,2,15.0013
336,274,62,12,28.7,42,2012,2,14.61949747
315,250,65,13,28.7,37,2012,2,19.0012
265,198,67,14,29.52,37,2012,2,16.9979
333,234,99,15,30.34,30,2012,2,17.93519771
466,389,77,16,29.52,34,2012,2,15.0013
602,537,65,19,28.7,34,2012,2,19.0012
478,402,76,20,27.06,36,2012,2,19.9995
313,283,30,21,25.42,41,2012,2,22.0028
228,193,35,22,24.6,46,2012,2,11.0014
177,135,42,23,22.96,52,2012,2,8.9981
77,59,18,0,22.96,56,2012,2,11.0014
29,25,4,1,22.96,56,2012,2,11.0014
19,17,2,2,22.96,56,2012,2,13.71542867
8,8,0,3,22.14,60,2012,2,6.0032
10,9,1,4,21.32,63,2012,2,12.55851719
29,28,1,5,20.5,72,2012,2,7.0015
139,131,8,6,21.32,68,2012,2,6.0032
428,409,19,7,21.32,72,2012,2,7.0015
700,663,37,8,23.78,60,2012,2,6.0032
382,335,47,9,25.42,53,2012,2,11.0014
249,187,62,10,27.06,47,2012,2,16.9979
264,199,65,11,28.7,42,2012,2,16.9979
369,280,89,12,29.52,39,2012,2,22.0028
416,287,129,13,30.34,37,2012,2,16.9979
373,245,128,14,31.16,31,2012,2,26.0027
397,299,98,15,31.16,29,2012,2,19.0012
523,412,111,16,31.16,29,2012,2,19.9995
723,576,147,18,31.16,27,2012,2,15.0013
555,460,95,19,30.34,30,2012,2,15.0013
408,291,117,20,29.52,32,2012,2,8.9981
339,256,83,21,28.7,37,2012,2,8.9981
291,230,61,22,27.88,41,2012,2,7.0015
215,163,52,23,26.24,57,2012,2,11.0014
206,152,54,0,26.24,53,2012,2,7.0015
123,89,34,1,26.24,53,2012,2,6.0032
89,68,21,2,26.24,50,2012,2,15.0013
40,28,12,3,25.42,57,2012,2,12.95854444
8,6,2,4,25.42,57,2012,2,12.95854444
19,15,4,5,24.6,56,2012,2,7.0015
80,63,17,6,22.96,64,2012,2,7.0015
87,61,26,7,23.78,64,2012,2,7.0015
244,202,42,8,25.42,61,2012,2,7.0015
340,241,99,9,26.24,57,2012,2,11.0014
466,298,168,10,28.7,51,2012,2,7.0015
569,351,218,11,31.16,35,2012,2,15.09594901
531,335,196,12,32.8,29,2012,2,16.9979
585,349,236,13,33.62,24,2012,2,19.0012
593,354,239,14,33.62,23,2012,2,12.998
555,337,218,15,34.44,20,2012,2,19.9995
534,315,219,16,33.62,24,2012,2,12.998
495,257,238,17,34.44,24,2012,2,19.54061444
451,276,175,18,33.62,24,2012,2,15.0013
360,232,128,19,32.8,29,2012,2,11.0014
363,238,125,20,31.16,35,2012,2,15.0013
316,211,105,21,30.34,40,2012,2,12.998
214,151,63,22,28.7,58,2012,2,11.0014
230,161,69,23,27.88,61,2012,2,11.0014
158,125,33,0,27.06,69,2012,2,7.0015
116,84,32,1,26.24,73,2012,2,8.9981
73,56,17,2,26.24,69,2012,2,8.9981
29,23,6,3,26.24,73,2012,2,7.0015
10,9,1,4,25.42,78,2012,2,6.0032
13,10,3,5,25.42,69,2012,2,6.0032
30,27,3,6,25.42,73,2012,2,11.40777998
62,41,21,7,24.6,78,2012,2,7.0015
181,122,59,8,26.24,73,2012,2,6.0032
266,175,91,9,28.7,58,2012,2,13.12086001
413,265,148,10,31.16,40,2012,2,7.0015
499,315,184,11,31.16,45,2012,2,6.0032
502,329,173,12,33.62,30,2012,2,16.71650071
492,288,204,13,34.44,28,2012,2,8.9981
500,314,186,14,34.44,30,2012,2,8.9981
475,316,159,15,34.44,30,2012,2,15.0013
508,335,173,16,34.44,36,2012,2,19.0012
521,337,184,17,33.62,41,2012,2,19.0012
490,326,164,18,33.62,38,2012,2,15.0013
375,260,115,19,33.62,28,2012,2,19.0012
363,250,113,20,31.16,48,2012,2,11.0014
253,170,83,21,29.52,62,2012,2,11.0014
159,117,42,22,28.7,65,2012,2,11.0014
110,80,30,23,29.52,58,2012,2,7.0015
41,33,8,0,28.7,65,2012,2,7.0015
24,15,9,1,27.06,74,2012,2,11.0014
17,12,5,2,27.06,74,2012,2,7.0015
6,4,2,3,26.24,78,2012,2,7.0015
7,7,0,4,26.24,78,2012,2,8.9981
37,36,1,5,26.24,78,2012,2,8.9981
144,136,8,6,25.42,83,2012,2,7.0015
503,478,25,7,26.24,78,2012,2,7.0015
651,613,38,8,27.06,74,2012,2,8.9981
316,259,57,9,28.7,65,2012,2,8.9981
147,95,52,10,29.52,62,2012,2,11.0014
202,143,59,11,31.16,48,2012,2,15.0013
261,198,63,12,32.8,43,2012,2,12.998
248,185,63,13,32.8,41,2012,2,19.9995
259,193,66,14,33.62,34,2012,2,19.0012
259,187,72,15,32.8,41,2012,2,23.9994
427,340,87,16,32.8,41,2012,2,27.9993
596,507,89,19,31.16,48,2012,2,22.0028
394,333,61,20,30.34,48,2012,2,15.0013
250,218,32,21,29.52,58,2012,2,12.998
164,142,22,22,29.52,58,2012,2,12.998
80,72,8,23,28.7,58,2012,2,15.0013
28,26,2,0,28.7,58,2012,2,15.0013
16,11,5,1,27.88,65,2012,2,11.0014
6,6,0,2,27.88,65,2012,2,12.998
12,9,3,3,27.06,69,2012,2,16.9979
4,4,0,4,24.6,88,2012,2,11.0014
29,28,1,5,24.6,88,2012,2,8.9981
136,130,6,6,24.6,88,2012,2,8.9981
303,287,16,7,25.42,88,2012,2,16.9979
613,598,15,8,25.42,88,2012,2,15.0013
285,254,31,9,26.24,89,2012,2,19.0012
125,96,29,10,26.24,89,2012,2,19.0012
65,57,8,11,27.06,83,2012,2,23.9994
95,76,19,12,27.06,83,2012,2,16.9979
59,48,11,13,27.06,83,2012,2,12.998
60,48,12,14,26.24,89,2012,2,16.9979
116,94,22,15,27.06,89,2012,2,12.998
239,209,30,16,27.06,89,2012,2,19.0012
681,625,56,17,27.06,89,2012,2,19.0012
653,596,57,18,27.88,83,2012,2,12.998
491,444,47,19,27.88,83,2012,2,12.998
386,350,36,20,27.88,83,2012,2,12.998
274,233,41,21,27.88,83,2012,2,7.0015
207,188,19,22,27.06,94,2012,2,7.0015
89,78,11,23,27.06,94,2012,2,15.0013
34,27,7,0,27.06,94,2012,2,12.998
28,21,7,1,26.24,78,2012,2,10.68412195
4,4,0,2,25.42,83,2012,2,8.9981
8,7,1,3,25.42,83,2012,2,12.998
10,9,1,4,24.6,83,2012,2,8.9981
40,38,2,5,24.6,83,2012,2,12.998
194,188,6,6,24.6,83,2012,2,15.0013
505,480,25,7,24.6,83,2012,2,19.9995
713,672,41,8,25.42,73,2012,2,35.0008
352,298,54,9,26.24,69,2012,2,39.0007
198,134,64,10,26.24,65,2012,2,27.9993
246,182,64,11,27.06,54,2012,2,30.0026
334,241,93,12,27.88,44,2012,2,27.9993
255,203,52,13,28.7,45,2012,2,26.0027
320,222,98,14,29.52,37,2012,2,27.9993
281,216,65,15,29.52,32,2012,2,32.9975
392,320,72,16,29.52,30,2012,2,32.9975
671,548,123,19,28.7,34,2012,2,26.0027
448,362,86,20,27.88,36,2012,2,27.9993
396,317,79,21,26.24,44,2012,2,23.9994
238,209,29,22,25.42,50,2012,2,19.9995
153,128,25,23,25.42,50,2012,2,19.0012
48,45,3,0,24.6,53,2012,2,19.9995
21,17,4,1,24.6,56,2012,2,15.0013
9,8,1,2,25.42,53,2012,2,16.9979
5,4,1,3,25.42,53,2012,2,19.0012
6,6,0,4,24.6,56,2012,2,16.9979
40,40,0,5,24.6,56,2012,2,16.9979
181,169,12,6,23.78,60,2012,2,19.0012
506,480,26,7,24.6,60,2012,2,19.0012
719,682,37,8,24.6,64,2012,2,22.0028
357,312,45,9,25.42,61,2012,2,15.0013
179,132,47,10,26.24,65,2012,2,27.9993
228,168,60,11,27.06,57,2012,2,16.9979
265,210,55,12,27.06,61,2012,2,15.0013
284,213,71,13,27.88,57,2012,2,11.0014
298,214,84,14,28.7,54,2012,2,19.0012
324,213,111,15,30.34,48,2012,2,19.9995
438,368,70,16,29.52,51,2012,2,19.0012
579,483,96,19,28.7,48,2012,2,16.9979
435,351,84,20,27.06,65,2012,2,16.9979
337,270,67,21,26.24,65,2012,2,11.0014
242,196,46,22,26.24,65,2012,2,15.0013
172,136,36,23,25.42,69,2012,2,11.0014
94,68,26,0,24.6,73,2012,2,11.0014
51,42,9,1,23.78,78,2012,2,12.998
15,15,0,2,22.96,83,2012,2,7.0015
5,3,2,3,22.96,83,2012,2,11.0014
14,13,1,4,22.96,83,2012,2,11.0014
33,31,2,5,22.14,88,2012,2,7.0015
151,142,9,6,22.14,83,2012,2,8.9981
430,413,17,7,22.96,83,2012,2,11.0014
653,609,44,8,24.6,69,2012,2,11.0014
366,308,58,9,25.42,65,2012,2,11.0014
216,160,56,10,26.24,57,2012,2,11.0014
286,180,106,11,27.06,50,2012,2,12.998
403,292,111,12,28.7,45,2012,2,11.0014
393,272,121,13,28.7,42,2012,2,16.9979
376,255,121,14,29.52,39,2012,2,12.998
377,270,107,15,29.52,39,2012,2,12.998
558,426,132,16,29.52,37,2012,2,12.998
693,572,121,18,29.52,39,2012,2,15.0013
467,369,98,19,28.7,42,2012,2,11.0014
385,296,89,20,27.88,44,2012,2,12.998
333,250,83,21,27.06,50,2012,2,7.0015
321,242,79,22,26.24,53,2012,2,8.9981
222,176,46,23,25.42,53,2012,2,16.9979
137,112,25,0,23.78,56,2012,2,8.9981
95,79,16,1,22.96,56,2012,2,13.71542867
67,55,12,2,23.78,53,2012,2,14.93336719
27,19,8,3,22.96,60,2012,2,6.0032
8,5,3,4,22.14,68,2012,2,8.9981
23,21,2,5,22.14,68,2012,2,7.0015
47,36,11,6,22.14,68,2012,2,12.998
78,68,10,7,22.14,68,2012,2,12.998
204,157,47,8,23.78,64,2012,2,11.0014
367,279,88,9,24.6,60,2012,2,6.0032
435,296,139,10,26.24,47,2012,2,12.998
566,353,213,11,27.06,39,2012,2,11.0014
603,349,254,12,27.88,41,2012,2,7.0015
617,324,293,13,29.52,34,2012,2,11.0014
573,309,264,14,29.52,37,2012,2,15.0013
583,288,295,15,30.34,35,2012,2,16.9979
542,304,238,16,29.52,37,2012,2,7.0015
593,349,244,17,29.52,37,2012,2,16.9979
571,315,256,18,29.52,37,2012,2,15.0013
461,277,184,19,28.7,42,2012,2,12.998
352,229,123,20,27.06,47,2012,2,12.998
290,192,98,21,26.24,50,2012,2,15.0013
280,189,91,22,25.42,53,2012,2,19.9995
183,134,49,23,24.6,53,2012,2,19.9995
148,117,31,0,22.96,56,2012,2,8.9981
88,67,21,1,22.96,60,2012,2,11.0014
74,55,19,2,22.96,56,2012,2,6.0032
28,22,6,3,22.14,64,2012,2,7.0015
18,16,2,4,22.14,64,2012,2,6.0032
17,13,4,5,22.14,68,2012,2,8.9981
23,16,7,6,21.32,72,2012,2,7.0015
48,30,18,7,21.32,72,2012,2,6.0032
119,95,24,8,22.96,68,2012,2,16.9979
274,183,91,9,22.96,68,2012,2,11.0014
436,288,148,10,23.78,64,2012,2,12.01988675
546,350,196,11,25.42,57,2012,2,7.0015
615,355,260,12,25.42,57,2012,2,12.95854444
614,347,267,13,26.24,53,2012,2,11.0014
582,327,255,14,26.24,53,2012,2,13.97960028
463,260,203,15,27.06,50,2012,2,15.0013
580,340,240,16,27.06,54,2012,2,19.9995
593,361,232,17,26.24,57,2012,2,15.0013
513,310,203,18,26.24,53,2012,2,12.998
390,244,146,19,26.24,53,2012,2,11.0014
302,201,101,20,25.42,57,2012,2,12.998
246,170,76,21,25.42,57,2012,2,12.998
153,98,55,22,24.6,60,2012,2,12.998
108,79,29,23,23.78,64,2012,2,12.998
40,28,12,0,22.96,73,2012,2,16.9979
14,5,9,1,22.14,77,2012,2,15.0013
9,6,3,2,22.14,77,2012,2,15.0013
4,3,1,3,21.32,83,2012,2,15.0013
9,9,0,4,22.14,77,2012,2,12.998
23,22,1,5,21.32,83,2012,2,8.9981
37,37,0,6,21.32,88,2012,2,8.9981
145,135,10,7,21.32,94,2012,2,15.0013
474,447,27,8,22.14,83,2012,2,12.998
250,222,28,9,22.14,83,2012,2,15.0013
91,78,13,10,22.14,88,2012,2,7.0015
121,96,25,11,22.14,88,2012,2,11.0014
168,139,29,12,22.96,78,2012,2,8.9981
225,174,51,13,23.78,73,2012,2,8.9981
219,160,59,14,23.78,68,2012,2,12.998
237,176,61,15,24.6,69,2012,2,12.998
332,279,53,16,24.6,73,2012,2,12.998
723,669,54,17,24.6,73,2012,2,12.998
642,595,47,18,25.42,69,2012,2,11.0014
463,411,52,19,25.42,73,2012,2,6.0032
362,317,45,20,25.42,73,2012,2,8.9981
273,238,35,21,25.42,73,2012,2,7.0015
164,143,21,22,25.42,73,2012,2,11.0014
74,57,17,23,24.6,78,2012,2,12.998
35,30,5,0,24.6,78,2012,2,11.0014
14,13,1,1,24.6,78,2012,2,11.0014
15,14,1,2,24.6,78,2012,2,8.9981
8,7,1,3,24.6,78,2012,2,7.0015
10,9,1,4,24.6,78,2012,2,8.9981
37,34,3,5,24.6,78,2012,2,12.998
161,152,9,6,24.6,78,2012,2,7.0015
480,462,18,7,24.6,78,2012,2,8.9981
673,633,40,8,24.6,78,2012,2,11.0014
328,288,40,9,26.24,73,2012,2,6.0032
180,136,44,10,26.24,73,2012,2,6.0032
230,174,56,11,27.06,69,2012,2,8.9981
292,222,70,12,28.7,65,2012,2,6.0032
272,203,69,13,30.34,58,2012,2,8.9981
227,166,61,14,31.16,58,2012,2,7.0015
259,187,72,15,31.98,59,2012,2,11.0014
334,286,48,16,32.8,55,2012,2,15.0013
514,432,82,19,32.8,59,2012,2,15.0013
458,399,59,20,32.8,55,2012,2,16.9979
276,239,37,21,31.16,62,2012,2,11.0014
291,240,51,22,29.52,79,2012,2,6.0032
125,102,23,23,29.52,79,2012,2,8.9981
149,122,27,0,31.16,66,2012,3,11.30965771
93,81,12,1,30.34,70,2012,3,8.9981
90,69,21,2,29.52,74,2012,3,6.0032
33,27,6,3,29.52,84,2012,3,8.9981
4,4,0,4,28.7,79,2012,3,12.998
10,7,3,5,27.88,79,2012,3,7.0015
27,19,8,6,28.7,79,2012,3,6.0032
50,37,13,7,30.34,70,2012,3,11.51648144
142,106,36,8,31.98,62,2012,3,7.0015
219,168,51,9,33.62,56,2012,3,14.54754608
366,268,98,10,35.26,44,2012,3,19.9995
377,256,121,11,36.08,39,2012,3,15.0013
433,319,114,12,36.9,37,2012,3,15.0013
420,309,111,13,37.72,33,2012,3,16.9979
444,346,98,14,37.72,33,2012,3,16.9979
345,244,101,15,36.9,37,2012,3,19.0012
313,228,85,16,37.72,33,2012,3,19.9995
413,323,90,17,37.72,26,2012,3,19.9995
370,275,95,18,36.08,32,2012,3,23.9994
382,279,103,19,34.44,39,2012,3,8.9981
332,244,88,20,34.44,39,2012,3,8.9981
258,181,77,21,34.44,39,2012,3,8.9981
151,110,41,22,33.62,43,2012,3,8.9981
110,88,22,23,31.98,52,2012,3,11.0014
43,31,12,0,31.16,58,2012,3,15.0013
17,14,3,1,31.16,58,2012,3,12.998
15,14,1,2,30.34,51,2012,3,16.9979
5,5,0,3,29.52,54,2012,3,27.9993
12,10,2,4,29.52,54,2012,3,19.9995
40,37,3,5,29.52,51,2012,3,13.44861611
136,132,4,6,28.7,58,2012,3,7.0015
398,390,8,7,30.34,51,2012,3,7.0015
568,548,20,8,31.16,52,2012,3,12.998
295,239,56,9,31.98,46,2012,3,16.9979
174,104,70,10,32.8,43,2012,3,16.9979
201,134,67,11,34.44,28,2012,3,19.9995
257,183,74,12,34.44,32,2012,3,12.998
236,162,74,13,35.26,34,2012,3,15.0013
230,151,79,14,35.26,34,2012,3,15.0013
234,175,59,15,34.44,36,2012,3,12.998
365,304,61,16,34.44,36,2012,3,19.0012
730,658,72,18,34.44,32,2012,3,11.0014
581,510,71,19,31.98,43,2012,3,8.9981
395,357,38,20,31.98,43,2012,3,8.9981
258,241,17,21,31.16,45,2012,3,8.9981
188,169,19,22,30.34,51,2012,3,11.0014
102,90,12,23,30.34,51,2012,3,7.0015
53,44,9,0,29.52,54,2012,3,13.76440183
14,9,5,1,29.52,58,2012,3,13.3038319
10,8,2,2,29.52,58,2012,3,13.3038319
2,2,0,3,28.7,65,2012,3,8.9981
6,6,0,4,27.88,65,2012,3,7.0015
35,33,2,5,28.7,61,2012,3,12.39984285
154,149,5,6,28.7,65,2012,3,8.9981
483,462,21,7,30.34,58,2012,3,13.31525476
646,604,42,8,30.34,62,2012,3,6.0032
272,226,46,9,32.8,49,2012,3,11.0014
209,153,56,10,33.62,43,2012,3,15.0013
217,151,66,11,35.26,34,2012,3,12.998
272,198,74,12,36.08,28,2012,3,12.998
283,203,80,13,36.9,25,2012,3,8.9981
310,241,69,14,36.9,25,2012,3,12.998
401,330,71,15,36.9,24,2012,3,12.27117657
527,437,90,16,36.9,24,2012,3,12.998
722,620,102,17,35.26,30,2012,3,11.0014
627,542,85,18,35.26,30,2012,3,14.33162187
497,431,66,19,34.44,36,2012,3,8.9981
376,296,80,20,31.16,55,2012,3,32.9975
196,160,36,21,28.7,70,2012,3,19.0012
177,151,26,22,27.88,79,2012,3,12.998
171,152,19,23,27.06,83,2012,3,10.52608879
159,140,19,0,27.88,79,2012,3,6.0032
123,96,27,1,27.88,74,2012,3,11.37443206
93,66,27,2,27.06,83,2012,3,8.9981
32,23,9,3,27.88,74,2012,3,12.998
16,11,5,4,27.88,69,2012,3,16.9979
19,14,5,5,27.06,69,2012,3,11.48605617
32,23,9,6,27.06,69,2012,3,11.48605617
72,62,10,7,27.88,65,2012,3,11.49116035
153,110,43,8,28.7,61,2012,3,7.0015
293,203,90,9,31.16,52,2012,3,14.56819264
447,304,143,10,32.8,46,2012,3,14.76988294
485,321,164,11,33.62,46,2012,3,8.9981
494,330,164,12,35.26,41,2012,3,15.0013
499,322,177,13,36.9,35,2012,3,15.40176936
547,357,190,14,36.9,37,2012,3,11.0014
454,299,155,15,37.72,35,2012,3,19.9995
389,226,163,16,37.72,35,2012,3,16.9979
414,253,161,17,37.72,35,2012,3,19.9995
430,271,159,18,36.9,42,2012,3,12.998
432,255,177,19,35.26,47,2012,3,15.0013
551,314,237,20,35.26,47,2012,3,15.0013
584,362,222,21,34.44,53,2012,3,8.9981
502,327,175,22,33.62,56,2012,3,15.0013
183,152,31,23,31.98,43,2012,3,6.0032
88,71,17,0,30.34,51,2012,3,7.0015
30,24,6,1,30.34,51,2012,3,19.0012
18,14,4,2,30.34,51,2012,3,13.61148369
7,5,2,3,29.52,54,2012,3,12.998
7,7,0,4,29.52,58,2012,3,13.3038319
29,28,1,5,29.52,62,2012,3,12.43808933
133,130,3,6,29.52,58,2012,3,13.3038319
343,316,27,7,31.16,55,2012,3,13.99854241
550,514,36,8,32.8,49,2012,3,8.9981
293,246,47,9,34.44,49,2012,3,19.9995
186,117,69,10,35.26,44,2012,3,23.9994
244,137,107,11,36.9,35,2012,3,19.9995
276,188,88,12,36.9,35,2012,3,23.9994
310,181,129,13,37.72,33,2012,3,15.0013
241,154,87,14,37.72,33,2012,3,22.0028
254,183,71,15,37.72,33,2012,3,23.9994
433,324,109,16,37.72,33,2012,3,16.9979
689,575,114,17,37.72,35,2012,3,11.0014
607,511,96,18,36.9,39,2012,3,22.0028
503,375,128,19,36.08,39,2012,3,16.9979
321,243,78,20,35.26,41,2012,3,15.0013
323,232,91,21,34.44,47,2012,3,12.998
225,162,63,22,33.62,59,2012,3,8.9981
131,99,32,23,32.8,55,2012,3,11.0014
102,63,39,0,31.98,62,2012,3,8.9981
29,22,7,1,31.98,55,2012,3,15.0013
17,13,4,2,31.16,62,2012,3,8.9981
7,6,1,3,30.34,70,2012,3,12.998
6,4,2,4,30.34,66,2012,3,15.0013
35,31,4,5,30.34,66,2012,3,12.998
131,127,4,6,30.34,66,2012,3,12.998
353,333,20,7,31.98,46,2012,3,8.9981
585,557,28,8,32.8,41,2012,3,11.0014
304,249,55,9,33.62,36,2012,3,8.9981
210,130,80,10,35.26,30,2012,3,14.94549021
233,141,92,11,34.44,32,2012,3,6.0032
331,220,111,12,36.08,28,2012,3,7.0015
293,194,99,13,36.9,27,2012,3,7.0015
275,184,91,14,36.9,31,2012,3,11.0014
285,206,79,15,37.72,29,2012,3,12.998
369,300,69,16,37.72,29,2012,3,7.0015
576,486,90,17,37.72,29,2012,3,13.38841462
560,454,106,18,36.9,33,2012,3,16.9979
418,306,112,19,36.08,35,2012,3,15.0013
336,245,91,20,35.26,39,2012,3,7.0015
300,223,77,21,33.62,52,2012,3,8.9981
288,210,78,22,32.8,55,2012,3,12.998
164,137,27,23,32.8,63,2012,3,7.0015
150,115,35,0,31.98,66,2012,3,8.9981
71,55,16,1,31.16,70,2012,3,11.0014
58,47,11,2,31.16,72,2012,3,11.0014
31,19,12,3,30.34,74,2012,3,8.9981
16,13,3,4,30.34,74,2012,3,11.0014
14,12,2,5,30.34,74,2012,3,12.998
31,27,4,6,30.34,74,2012,3,7.0015
71,63,8,7,31.98,66,2012,3,7.0015
152,120,32,8,33.62,63,2012,3,12.998
256,187,69,9,34.44,59,2012,3,11.0014
325,225,100,10,37.72,37,2012,3,15.0013
367,245,122,11,38.54,38,2012,3,12.998
342,218,124,12,39.36,31,2012,3,23.9994
360,244,116,13,39.36,31,2012,3,16.9979
308,203,105,14,39.36,30,2012,3,8.9981
306,193,113,15,39.36,26,2012,3,13.09062727
294,192,102,16,41,19,2012,3,11.0014
279,176,103,17,39.36,26,2012,3,8.9981
277,194,83,18,38.54,29,2012,3,6.0032
287,219,68,19,37.72,33,2012,3,8.9981
276,197,79,20,36.9,37,2012,3,11.0014
201,150,51,21,36.08,37,2012,3,12.998
220,164,56,22,34.44,59,2012,3,12.998
148,114,34,23,34.44,56,2012,3,11.0014
147,125,22,0,33.62,56,2012,3,8.9981
124,99,25,1,33.62,56,2012,3,7.0015
70,59,11,2,33.62,52,2012,3,7.0015
35,34,1,3,32.8,59,2012,3,7.0015
13,11,2,4,31.98,66,2012,3,7.0015
6,5,1,5,31.98,62,2012,3,12.31211666
21,16,5,6,31.98,70,2012,3,8.9981
52,33,19,7,32.8,66,2012,3,11.47914721
130,95,35,8,34.44,53,2012,3,8.9981
242,172,70,9,35.26,50,2012,3,7.0015
319,234,85,10,36.9,45,2012,3,15.94480368
389,269,120,11,37.72,42,2012,3,19.9995
376,271,105,12,37.72,42,2012,3,12.998
337,219,118,13,38.54,38,2012,3,16.9979
312,235,77,14,39.36,36,2012,3,11.0014
298,218,80,15,37.72,42,2012,3,19.0012
291,226,65,16,32.8,66,2012,3,15.0013
270,202,68,17,31.98,59,2012,3,13.11382305
253,199,54,18,31.98,62,2012,3,7.0015
250,184,66,19,31.98,62,2012,3,11.0014
285,206,79,20,31.16,70,2012,3,6.0032
207,149,58,21,31.16,70,2012,3,8.9981
122,110,12,22,30.34,70,2012,3,6.0032
123,98,25,23,27.88,83,2012,3,6.0032
39,33,6,0,27.88,89,2012,3,6.0032
18,13,5,1,28.7,89,2012,3,7.0015
5,4,1,2,28.7,89,2012,3,12.998
5,5,0,3,28.7,89,2012,3,12.998
2,1,1,4,27.06,89,2012,3,26.0027
28,27,1,5,27.06,83,2012,3,15.0013
92,86,6,6,26.24,89,2012,3,16.9979
230,223,7,7,27.06,83,2012,3,15.0013
455,429,26,8,27.06,83,2012,3,11.0014
363,325,38,9,27.06,83,2012,3,11.0014
175,117,58,10,27.06,83,2012,3,12.998
216,144,72,11,29.52,62,2012,3,8.9981
266,205,61,12,30.34,58,2012,3,8.9981
255,188,67,13,31.16,55,2012,3,16.9979
242,184,58,14,30.34,55,2012,3,16.9979
280,214,66,15,31.16,45,2012,3,15.0013
413,325,88,16,31.98,40,2012,3,19.0012
631,543,88,19,30.34,55,2012,3,11.0014
447,378,69,20,30.34,55,2012,3,7.0015
331,298,33,21,30.34,55,2012,3,6.0032
224,189,35,22,29.52,58,2012,3,7.0015
131,109,22,23,28.7,65,2012,3,7.0015
69,53,16,0,28.7,70,2012,3,6.0032
15,15,0,1,28.7,74,2012,3,8.9981
16,15,1,2,28.7,74,2012,3,8.9981
3,3,0,3,27.88,79,2012,3,10.62096901
4,4,0,4,27.88,79,2012,3,8.9981
42,39,3,5,27.06,83,2012,3,8.9981
187,183,4,6,27.88,79,2012,3,7.0015
520,489,31,7,28.7,74,2012,3,7.0015
649,615,34,8,29.52,74,2012,3,8.9981
331,284,47,9,30.34,66,2012,3,8.9981
190,134,56,10,31.16,62,2012,3,12.998
249,157,92,11,32.8,46,2012,3,12.998
272,203,69,12,32.8,41,2012,3,8.9981
280,203,77,13,33.62,38,2012,3,12.998
242,171,71,14,33.62,38,2012,3,11.0014
265,188,77,15,32.8,41,2012,3,15.0013
435,346,89,16,32.8,43,2012,3,15.0013
414,359,55,19,28.7,74,2012,3,15.0013
84,75,9,20,26.24,83,2012,3,15.0013
90,83,7,21,26.24,89,2012,3,7.0015
139,125,14,22,26.24,83,2012,3,8.9981
103,74,29,23,26.24,89,2012,3,7.0015
44,38,6,0,27.06,83,2012,3,8.9981
14,11,3,1,26.24,89,2012,3,10.15424473
5,5,0,2,26.24,89,2012,3,10.15424473
5,5,0,3,26.24,89,2012,3,8.9981
7,6,1,4,26.24,89,2012,3,8.9981
41,36,5,5,26.24,89,2012,3,10.15424473
185,168,17,6,26.24,89,2012,3,8.9981
497,471,26,7,27.06,83,2012,3,7.0015
674,644,30,8,27.88,79,2012,3,11.0014
328,298,30,9,28.7,74,2012,3,8.9981
195,148,47,10,29.52,62,2012,3,8.9981
229,173,56,11,31.16,58,2012,3,8.9981
292,223,69,12,31.98,43,2012,3,14.32974298
273,208,65,13,32.8,42,2012,3,11.0014
241,175,66,14,32.8,41,2012,3,15.0013
276,220,56,15,32.8,41,2012,3,16.9979
411,358,53,16,32.8,38,2012,3,12.998
633,560,73,19,30.34,48,2012,3,15.0013
483,410,73,20,30.34,51,2012,3,11.0014
391,322,69,21,29.52,58,2012,3,15.0013
244,203,41,22,29.52,58,2012,3,16.9979
152,132,20,23,28.7,58,2012,3,16.9979
56,55,1,0,27.88,61,2012,3,12.5044021
21,21,0,1,27.06,61,2012,3,12.47634537
9,9,0,2,27.06,65,2012,3,6.0032
10,10,0,3,26.24,69,2012,3,7.0015
5,5,0,4,26.24,73,2012,3,7.0015
44,40,4,5,25.42,73,2012,3,7.0015
178,171,7,6,26.24,73,2012,3,6.0032
512,480,32,7,26.24,73,2012,3,8.9981
702,653,49,8,27.88,65,2012,3,8.9981
327,285,42,9,29.52,58,2012,3,7.0015
214,145,69,10,30.34,48,2012,3,11.0014
215,166,49,11,31.16,45,2012,3,7.0015
292,221,71,12,31.98,35,2012,3,8.9981
277,225,52,13,32.8,33,2012,3,15.0013
209,167,42,14,31.98,33,2012,3,15.0013
271,208,63,15,32.8,36,2012,3,12.998
439,370,69,16,32.8,36,2012,3,12.998
629,532,97,19,30.34,48,2012,3,15.0013
514,439,75,20,30.34,48,2012,3,15.0013
373,329,44,21,29.52,48,2012,3,15.0013
318,262,56,22,29.52,51,2012,3,11.0014
211,178,33,23,28.7,51,2012,3,15.0013
95,76,19,0,28.7,54,2012,3,11.0014
59,42,17,1,27.88,54,2012,3,7.0015
17,15,2,2,27.06,61,2012,3,6.0032
9,7,2,3,27.88,61,2012,3,12.5044021
11,11,0,4,27.06,61,2012,3,12.47634537
34,30,4,5,27.06,56,2012,3,6.0032
127,120,7,6,28.7,54,2012,3,13.69817587
380,353,27,7,28.7,54,2012,3,13.69817587
713,660,53,8,28.7,54,2012,3,13.69817587
414,344,70,9,29.52,51,2012,3,13.44861611
268,190,78,10,30.34,48,2012,3,13.2984336
288,220,68,11,31.16,45,2012,3,8.9981
379,254,125,12,31.16,40,2012,3,7.0015
374,274,100,13,32.8,38,2012,3,8.9981
369,249,120,14,32.8,38,2012,3,14.29758124
353,261,92,15,32.8,36,2012,3,7.0015
492,381,111,16,32.8,36,2012,3,15.0013
631,523,108,18,31.98,46,2012,3,12.998
488,385,103,19,30.34,51,2012,3,11.0014
389,294,95,20,30.34,48,2012,3,8.9981
299,223,76,21,29.52,54,2012,3,13.76440183
263,204,59,22,30.34,45,2012,3,13.57597896
212,175,37,23,29.52,45,2012,3,8.9981
191,156,35,0,29.52,48,2012,3,6.0032
118,105,13,1,28.7,51,2012,3,7.0015
101,91,10,2,28.7,54,2012,3,7.0015
40,31,9,3,28.7,54,2012,3,7.0015
9,6,3,4,27.06,61,2012,3,7.0015
5,5,0,5,26.24,73,2012,3,7.0015
35,29,6,6,26.24,78,2012,3,6.0032
48,41,7,7,26.24,78,2012,3,19.0012
151,118,33,8,25.42,78,2012,3,19.0012
282,200,82,9,27.06,74,2012,3,12.998
401,278,123,10,29.52,70,2012,3,6.0032
439,296,143,11,29.52,70,2012,3,7.0015
499,318,181,12,30.34,66,2012,3,6.0032
591,372,219,13,31.16,62,2012,3,6.0032
632,363,269,14,32.8,55,2012,3,7.0015
560,317,243,15,32.8,55,2012,3,11.0014
566,340,226,16,29.52,79,2012,3,23.9994
458,259,199,17,28.7,79,2012,3,11.0014
351,243,108,18,29.52,79,2012,3,8.9981
431,275,156,19,29.52,84,2012,3,6.0032
356,255,101,20,29.52,84,2012,3,6.0032
269,200,69,21,28.7,84,2012,3,15.0013
225,160,65,22,28.7,79,2012,3,12.998
211,156,55,23,27.88,83,2012,3,6.0032
187,147,40,0,27.88,89,2012,3,11.0014
168,119,49,1,27.88,89,2012,3,8.9981
115,86,29,2,27.88,89,2012,3,11.0014
57,42,15,3,27.88,89,2012,3,11.0014
19,11,8,4,27.88,89,2012,3,7.0015
9,7,2,5,27.88,89,2012,3,8.9981
15,9,6,6,27.88,83,2012,3,8.9981
47,30,17,7,28.7,79,2012,3,6.0032
133,96,37,8,28.7,84,2012,3,8.9981
221,163,58,9,29.52,79,2012,3,12.04672881
382,241,141,10,31.16,66,2012,3,8.9981
451,281,170,11,33.62,52,2012,3,11.0014
489,336,153,12,34.44,47,2012,3,7.0015
480,309,171,13,35.26,41,2012,3,7.0015
476,314,162,14,36.9,37,2012,3,16.9979
489,307,182,15,35.26,47,2012,3,8.9981
495,343,152,16,35.26,41,2012,3,15.0013
436,314,122,17,32.8,59,2012,3,32.9975
312,228,84,18,29.52,79,2012,3,23.9994
312,203,109,19,29.52,84,2012,3,15.0013
294,199,95,20,29.52,79,2012,3,16.9979
223,164,59,21,29.52,79,2012,3,6.0032
130,96,34,22,29.52,74,2012,3,7.0015
91,66,25,23,29.52,79,2012,3,8.9981
43,32,11,0,29.52,79,2012,3,7.0015
11,10,1,1,28.7,74,2012,3,12.998
15,11,4,2,28.7,74,2012,3,7.0015
6,4,2,3,27.88,79,2012,3,6.0032
12,11,1,4,27.88,79,2012,3,7.0015
50,40,10,5,27.06,78,2012,3,7.0015
140,132,8,6,27.88,79,2012,3,8.9981
483,459,24,7,29.52,70,2012,3,6.0032
667,619,48,8,30.34,66,2012,3,7.0015
348,297,51,9,31.16,62,2012,3,11.0014
186,117,69,10,32.8,59,2012,3,13.6362991
182,125,57,11,34.44,53,2012,3,15.0013
237,158,79,12,34.44,49,2012,3,8.9981
239,176,63,13,34.44,49,2012,3,19.0012
212,159,53,14,36.08,42,2012,3,7.0015
237,176,61,15,35.26,47,2012,3,16.9979
386,309,77,16,31.16,66,2012,3,39.0007
595,503,92,19,32.8,63,2012,3,8.9981
454,388,66,20,32.8,59,2012,3,8.9981
328,283,45,21,31.16,66,2012,3,8.9981
284,228,56,22,31.16,62,2012,3,6.0032
166,139,27,23,30.34,74,2012,3,6.0032
53,43,10,0,29.52,84,2012,3,7.0015
25,21,4,1,30.34,70,2012,3,11.51648144
7,6,1,2,29.52,70,2012,3,6.0032
3,3,0,3,29.52,66,2012,3,11.27902316
7,7,0,4,29.52,62,2012,3,12.43808933
38,31,7,5,27.88,74,2012,3,6.0032
213,197,16,6,29.52,66,2012,3,7.0015
526,500,26,7,30.34,70,2012,3,11.85266895
661,618,43,8,32.8,55,2012,3,14.37153115
320,288,32,9,33.62,49,2012,3,15.0013
159,122,37,10,34.44,49,2012,3,12.998
206,146,60,11,35.26,47,2012,3,15.25830048
254,174,80,12,36.9,35,2012,3,15.35453328
221,168,53,13,37.72,31,2012,3,12.998
214,160,54,14,38.54,29,2012,3,16.9979
244,187,57,15,37.72,31,2012,3,11.0014
381,317,64,16,37.72,29,2012,3,11.0014
547,478,69,19,36.08,35,2012,3,16.9979
427,375,52,20,35.26,34,2012,3,11.0014
333,283,50,21,33.62,52,2012,3,8.9981
244,215,29,22,32.8,55,2012,3,15.0013
161,139,22,23,31.98,59,2012,3,12.998
53,45,8,0,31.16,66,2012,3,11.0014
16,14,2,1,31.16,66,2012,3,7.0015
8,5,3,2,30.34,66,2012,3,8.9981
4,2,2,3,30.34,66,2012,3,8.9981
6,6,0,4,29.52,70,2012,3,8.9981
46,41,5,5,29.52,70,2012,3,11.0014
162,152,10,6,29.52,70,2012,3,11.0014
495,472,23,7,30.34,66,2012,3,11.0014
679,624,55,8,31.98,62,2012,3,7.0015
297,253,44,9,33.62,56,2012,3,14.54754608
138,99,39,10,36.9,42,2012,3,12.998
183,136,47,11,36.9,42,2012,3,15.90759389
202,166,36,12,37.72,37,2012,3,8.9981
203,154,49,13,38.54,33,2012,3,15.77586644
170,116,54,14,38.54,38,2012,3,22.0028
194,152,42,15,37.72,35,2012,3,23.9994
224,190,34,16,30.34,66,2012,3,16.9979
370,335,35,17,30.34,70,2012,3,16.9979
643,580,63,18,31.16,62,2012,3,8.9981
516,438,78,19,31.16,62,2012,3,7.0015
366,310,56,20,30.34,62,2012,3,6.0032
319,266,53,21,31.16,62,2012,3,12.43401114
288,246,42,22,31.16,58,2012,3,6.0032
131,112,19,23,31.16,58,2012,3,6.0032
66,50,16,0,30.34,66,2012,3,6.0032
25,19,6,1,30.34,66,2012,3,6.0032
7,7,0,2,29.52,70,2012,3,12.998
5,4,1,3,29.52,70,2012,3,7.0015
8,8,0,4,29.52,70,2012,3,7.0015
40,35,5,5,29.52,70,2012,3,7.0015
152,144,8,6,29.52,66,2012,3,8.9981
473,450,23,7,30.34,58,2012,3,19.0012
657,625,32,8,31.16,58,2012,3,16.9979
318,282,36,9,31.16,58,2012,3,19.0012
198,157,41,10,31.16,58,2012,3,12.998
216,162,54,11,32.8,55,2012,3,7.0015
274,215,59,12,34.44,49,2012,3,19.0012
254,180,74,13,34.44,47,2012,3,8.9981
197,151,46,14,35.26,44,2012,3,6.0032
292,226,66,15,34.44,47,2012,3,6.0032
358,288,70,16,34.44,47,2012,3,6.0032
533,480,53,19,34.44,44,2012,3,16.9979
505,440,65,20,33.62,49,2012,3,11.0014
332,294,38,21,27.06,89,2012,3,16.9979
68,62,6,22,27.06,89,2012,3,16.9979
65,62,3,23,27.06,89,2012,3,15.0013
47,44,3,0,27.88,79,2012,3,11.0014
33,28,5,1,27.06,83,2012,3,6.0032
13,13,0,2,26.24,83,2012,3,7.0015
7,7,0,3,26.24,83,2012,3,7.0015
4,3,1,4,26.24,78,2012,3,8.9981
49,46,3,5,26.24,78,2012,3,8.9981
185,179,6,6,26.24,78,2012,3,8.9981
487,468,19,7,26.24,83,2012,3,8.9981
681,649,32,8,27.06,78,2012,3,12.998
350,316,34,9,27.88,74,2012,3,6.0032
236,175,61,10,29.52,66,2012,3,6.0032
234,180,54,11,31.16,58,2012,3,6.0032
284,209,75,12,32.8,49,2012,3,7.0015
280,221,59,13,32.8,52,2012,3,11.0014
263,175,88,14,33.62,46,2012,3,11.0014
295,206,89,15,33.62,46,2012,3,11.0014
479,386,93,16,32.8,55,2012,3,19.0012
652,564,88,19,30.34,66,2012,3,16.9979
513,448,65,20,30.34,66,2012,3,11.0014
320,284,36,21,29.52,70,2012,3,8.9981
288,251,37,22,29.52,70,2012,3,7.0015
152,134,18,23,28.7,74,2012,3,12.23495249
63,55,8,0,28.7,74,2012,3,12.23495249
42,36,6,1,27.88,79,2012,3,7.0015
11,8,3,2,27.06,83,2012,3,6.0032
6,6,0,3,27.06,83,2012,3,10.66210137
9,9,0,4,27.06,83,2012,3,10.66210137
41,37,4,5,27.06,89,2012,3,8.9981
183,177,6,6,27.06,83,2012,3,10.66210137
473,452,21,7,28.7,79,2012,3,10.85284768
343,312,31,9,31.16,66,2012,3,7.0015
181,130,51,10,32.8,55,2012,3,14.94794748
226,167,59,11,33.62,52,2012,3,7.0015
286,230,56,12,34.44,44,2012,3,8.9981
310,212,98,13,35.26,44,2012,3,15.0013
225,171,54,14,35.26,41,2012,3,8.9981
270,202,68,15,31.98,62,2012,3,31.0009
406,335,71,16,33.62,46,2012,3,12.998
607,509,98,19,32.8,63,2012,3,11.0014
427,376,51,20,31.98,66,2012,3,13.2868833
342,301,41,21,31.16,66,2012,3,15.0013
262,227,35,22,30.34,70,2012,3,12.998
177,152,25,23,29.52,70,2012,3,16.9979
71,56,15,0,29.52,70,2012,3,12.998
43,32,11,1,28.7,74,2012,3,12.998
14,14,0,2,27.88,79,2012,3,15.0013
6,5,1,3,27.88,79,2012,3,15.0013
12,11,1,4,27.06,83,2012,3,16.9979
37,35,2,5,27.06,83,2012,3,11.0014
163,158,5,6,27.06,83,2012,3,15.0013
421,396,25,7,28.7,74,2012,3,7.0015
668,636,32,8,29.52,70,2012,3,8.9981
396,327,69,9,30.34,66,2012,3,7.0015
249,167,82,10,32.8,52,2012,3,12.998
263,186,77,11,34.44,49,2012,3,19.0012
338,243,95,12,35.26,50,2012,3,19.9995
345,247,98,13,35.26,47,2012,3,19.0012
331,229,102,14,35.26,44,2012,3,16.9979
380,268,112,15,36.08,42,2012,3,16.9979
492,380,112,16,35.26,41,2012,3,15.0013
671,573,98,18,33.62,59,2012,3,16.9979
469,388,81,19,32.8,63,2012,3,15.0013
389,300,89,20,31.98,66,2012,3,15.0013
278,224,54,21,31.16,66,2012,3,12.998
202,156,46,22,31.16,70,2012,3,16.9979
196,170,26,23,30.34,79,2012,3,8.9981
161,137,24,0,30.34,79,2012,3,11.0014
122,99,23,1,29.52,84,2012,3,12.998
84,64,20,2,29.52,84,2012,3,8.9981
30,19,11,3,29.52,84,2012,3,8.9981
13,11,2,4,29.52,79,2012,3,12.998
17,16,1,5,28.7,84,2012,3,15.0013
49,37,12,6,28.7,84,2012,3,15.0013
67,49,18,7,29.52,77,2012,3,11.0014
181,132,49,8,30.34,72,2012,3,12.998
278,217,61,9,31.98,65,2012,3,15.0013
396,288,108,10,33.62,57,2012,3,12.998
470,315,155,11,35.26,47,2012,3,16.9979
547,325,222,12,35.26,40,2012,3,23.9994
527,332,195,13,36.08,42,2012,3,19.9995
472,289,183,14,36.08,40,2012,3,26.0027
489,284,205,15,36.08,42,2012,3,27.9993
450,253,197,16,36.9,39,2012,3,19.9995
492,313,179,17,36.08,37,2012,3,19.9995
490,321,169,18,35.26,41,2012,3,22.0028
397,264,133,19,33.62,52,2012,3,23.9994
312,195,117,20,33.62,52,2012,3,19.9995
289,193,96,21,32.8,59,2012,3,16.9979
269,165,104,22,31.16,66,2012,3,19.0012
222,161,61,23,31.16,66,2012,3,19.9995
153,121,32,0,30.34,70,2012,3,19.0012
87,79,8,1,30.34,70,2012,3,16.9979
73,68,5,2,30.34,70,2012,3,19.9995
41,32,9,3,29.52,74,2012,3,16.9979
14,11,3,4,29.52,74,2012,3,16.9979
19,18,1,5,29.52,74,2012,3,16.9979
19,12,7,6,29.52,79,2012,3,16.9979
68,50,18,7,30.34,74,2012,3,19.9995
108,81,27,8,31.16,66,2012,3,22.0028
229,168,61,9,32.8,59,2012,3,23.9994
364,253,111,10,32.8,59,2012,3,27.9993
437,282,155,11,33.62,56,2012,3,27.9993
491,330,161,12,35.26,47,2012,3,35.0008
523,315,208,13,36.08,44,2012,3,31.0009
526,365,161,14,36.9,42,2012,3,31.0009
450,286,164,15,36.9,37,2012,3,35.0008
421,278,143,16,33.62,46,2012,3,16.9979
382,260,122,17,33.62,46,2012,3,16.9979
229,154,75,18,28.7,74,2012,3,8.9981
185,139,46,19,28.7,84,2012,3,15.0013
193,140,53,20,28.7,84,2012,3,7.0015
208,157,51,21,29.52,79,2012,3,7.0015
157,100,57,22,29.52,79,2012,3,6.0032
87,58,29,23,29.52,79,2012,3,11.0014
33,24,9,0,29.52,79,2012,3,13.52488206
11,10,1,1,29.52,79,2012,3,6.0032
5,5,0,2,29.52,79,2012,3,8.9981
5,5,0,3,29.52,79,2012,3,6.0032
11,8,3,4,29.52,74,2012,3,8.9981
25,23,2,5,28.7,79,2012,3,12.998
141,137,4,6,28.7,79,2012,3,15.0013
407,393,14,7,29.52,70,2012,3,12.998
605,578,27,8,28.7,79,2012,3,13.63210494
276,248,28,9,28.7,79,2012,3,11.0014
213,159,54,10,30.34,70,2012,3,15.0013
260,152,108,11,31.16,66,2012,3,8.9981
285,213,72,12,31.98,55,2012,3,6.0032
289,204,85,13,32.8,49,2012,3,15.0013
287,188,99,14,33.62,46,2012,3,14.93635836
274,183,91,15,33.62,46,2012,3,8.9981
451,363,88,16,34.44,41,2012,3,7.0015
640,531,109,19,31.98,59,2012,3,12.998
457,368,89,20,31.16,66,2012,3,11.0014
317,245,72,21,30.34,70,2012,3,12.998
207,157,50,22,30.34,70,2012,3,6.0032
113,97,16,23,29.52,74,2012,3,12.998
47,32,15,0,28.7,84,2012,3,12.998
18,16,2,1,28.7,84,2012,3,8.9981
13,7,6,2,28.7,84,2012,3,8.9981
6,6,0,3,28.7,84,2012,3,10.61916599
9,7,2,4,27.88,83,2012,3,8.9981
36,33,3,5,28.7,79,2012,3,7.0015
179,176,3,6,28.7,79,2012,3,12.998
502,481,21,7,28.7,74,2012,3,8.9981
705,664,41,8,28.7,70,2012,3,11.0014
327,283,44,9,28.7,74,2012,3,8.9981
250,161,89,10,30.34,70,2012,3,8.9981
214,130,84,11,31.16,66,2012,3,6.0032
283,197,86,12,32.8,55,2012,3,8.9981
253,185,68,13,32.8,52,2012,3,12.998
261,185,76,14,33.62,46,2012,3,14.82442162
306,206,100,15,32.8,52,2012,3,15.25756042
445,344,101,16,31.16,66,2012,3,19.0012
610,506,104,19,31.16,66,2012,3,7.0015
448,374,74,20,30.34,70,2012,3,8.9981
317,247,70,21,29.52,74,2012,3,13.0538231
224,181,43,22,29.52,74,2012,3,7.0015
138,120,18,23,29.52,79,2012,3,10.56710751
58,46,12,0,28.7,84,2012,3,10.61916599
23,20,3,1,29.52,79,2012,3,10.56710751
6,5,1,2,28.7,84,2012,3,10.61916599
7,6,1,3,28.7,84,2012,3,10.61916599
7,6,1,4,28.7,84,2012,3,10.61916599
43,40,3,5,27.88,89,2012,3,11.0014
173,169,4,6,28.7,84,2012,3,11.0014
482,458,24,7,28.7,84,2012,3,11.0014
341,308,33,9,31.16,66,2012,3,13.07586999
214,151,63,10,32.8,52,2012,3,8.9981
239,159,80,11,32.8,52,2012,3,15.03230522
280,217,63,12,32.8,52,2012,3,15.03230522
313,212,101,13,32.8,52,2012,3,15.03230522
236,173,63,14,32.8,52,2012,3,16.9979
278,168,110,15,34.44,44,2012,3,12.998
441,328,113,16,32.8,49,2012,3,19.0012
686,567,119,19,31.16,66,2012,3,15.0013
500,424,76,20,30.34,66,2012,3,12.998
381,311,70,21,30.34,66,2012,3,7.0015
233,198,35,22,29.52,74,2012,3,7.0015
136,120,16,23,29.52,70,2012,3,8.9981
67,51,16,0,29.52,74,2012,3,12.998
28,23,5,1,28.7,79,2012,3,8.9981
14,12,2,2,28.7,84,2012,3,6.0032
6,5,1,3,27.88,83,2012,3,6.0032
10,10,0,4,27.88,89,2012,3,8.9981
41,37,4,5,27.06,94,2012,3,11.02943132
167,162,5,6,27.06,83,2012,3,11.0014
475,451,24,7,28.7,84,2012,3,11.0014
698,670,28,8,29.52,74,2012,3,7.0015
353,299,54,9,31.16,66,2012,3,11.0014
205,133,72,10,32.8,55,2012,3,15.0013
260,166,94,11,34.44,44,2012,3,14.95987207
277,192,85,12,34.44,44,2012,3,7.0015
281,201,80,13,35.26,41,2012,3,7.0015
247,161,86,14,36.08,32,2012,3,15.0013
267,204,63,15,36.08,32,2012,3,15.0013
417,320,97,16,35.26,39,2012,3,16.9979
623,533,90,19,32.8,55,2012,3,12.998
478,387,91,20,28.7,54,2012,3,19.0012
336,286,50,21,28.7,58,2012,3,11.0014
259,218,41,22,27.06,69,2012,3,15.0013
156,137,19,23,27.06,74,2012,3,11.85220072
85,68,17,0,28.7,65,2012,3,6.0032
41,35,6,1,28.7,65,2012,3,7.0015
20,14,6,2,28.7,74,2012,3,11.0014
9,6,3,3,29.52,79,2012,3,12.998
7,7,0,4,28.7,84,2012,3,19.0012
33,29,4,5,28.7,84,2012,3,19.0012
44,41,3,6,26.24,89,2012,3,19.9995
133,128,5,7,26.24,89,2012,3,7.0015
119,112,7,8,25.42,91,2012,3,11.0014
220,199,21,9,26.24,89,2012,3,11.11710412
193,166,27,10,27.06,89,2012,3,7.0015
251,178,73,11,27.88,79,2012,3,8.9981
315,240,75,12,30.34,66,2012,3,23.9994
290,224,66,13,31.16,58,2012,3,23.9994
307,236,71,14,31.16,58,2012,3,23.9994
324,224,100,15,32.8,52,2012,3,30.0026
467,371,96,16,31.98,55,2012,3,19.9995
730,619,111,17,32.8,52,2012,3,19.0012
640,552,88,18,31.16,62,2012,3,19.9995
492,394,98,19,31.16,62,2012,3,19.0012
370,315,55,20,30.34,66,2012,3,19.9995
286,236,50,21,30.34,66,2012,3,16.9979
218,168,50,22,29.52,74,2012,3,19.0012
192,159,33,23,29.52,70,2012,3,19.0012
180,142,38,0,28.7,70,2012,3,19.0012
116,84,32,1,27.06,74,2012,3,15.0013
85,66,19,2,26.24,78,2012,3,12.998
21,19,2,3,25.42,83,2012,3,11.0014
10,7,3,4,25.42,83,2012,3,7.0015
11,9,2,5,25.42,88,2012,3,7.0015
23,18,5,6,25.42,88,2012,3,7.0015
62,54,8,7,26.24,83,2012,3,6.0032
162,132,30,8,27.06,83,2012,3,7.0015
271,217,54,9,27.88,79,2012,3,12.998
407,282,125,10,29.52,62,2012,3,6.0032
499,296,203,11,30.34,66,2012,3,11.0014
546,332,214,12,31.16,58,2012,3,15.0013
569,341,228,13,32.8,49,2012,3,23.9994
538,290,248,14,32.8,49,2012,3,19.9995
562,316,246,15,32.8,46,2012,3,19.0012
531,304,227,16,32.8,46,2012,3,19.9995
512,292,220,17,30.34,66,2012,3,23.9994
300,193,107,18,28.7,74,2012,3,19.9995
275,178,97,19,27.06,89,2012,3,7.0015
160,129,31,20,27.06,89,2012,3,27.9993
128,102,26,21,27.06,89,2012,3,11.0014
168,128,40,22,27.06,89,2012,3,11.0014
163,121,42,23,27.06,78,2012,3,11.0014
120,96,24,0,26.24,73,2012,3,8.9981
113,92,21,1,25.42,78,2012,3,8.9981
86,67,19,2,26.24,69,2012,3,8.9981
48,37,11,3,25.42,73,2012,3,6.0032
10,8,2,4,26.24,69,2012,3,6.0032
10,9,1,5,26.24,61,2012,3,12.998
16,14,2,6,26.24,65,2012,3,11.0014
39,30,9,7,26.24,65,2012,3,8.9981
119,84,35,8,27.06,54,2012,3,15.0013
217,153,64,9,28.7,48,2012,3,15.0013
328,240,88,10,28.7,51,2012,3,11.0014
449,282,167,11,30.34,42,2012,3,11.0014
505,342,163,12,30.34,42,2012,3,12.998
543,365,178,13,31.98,40,2012,3,14.52330276
579,366,213,14,31.16,40,2012,3,12.998
577,342,235,15,31.16,40,2012,3,8.9981
513,300,213,16,31.16,40,2012,3,7.0015
505,319,186,17,32.8,33,2012,3,14.76374466
491,327,164,18,31.98,35,2012,3,7.0015
465,317,148,19,30.34,40,2012,3,8.9981
300,204,96,20,29.52,45,2012,3,13.37343942
220,142,78,21,29.52,51,2012,3,6.0032
181,141,40,22,28.7,58,2012,3,8.9981
110,85,25,23,27.88,61,2012,3,13.33829918
47,33,14,0,27.06,65,2012,3,7.0015
14,11,3,1,27.06,65,2012,3,6.0032
9,8,1,2,26.24,69,2012,3,7.0015
6,5,1,3,26.24,69,2012,3,11.66436854
11,11,0,4,26.24,69,2012,3,7.0015
36,33,3,5,26.24,69,2012,3,7.0015
159,155,4,6,25.42,73,2012,3,6.0032
436,425,11,7,27.06,65,2012,3,8.9981
673,648,25,8,29.52,51,2012,3,6.0032
305,265,40,9,30.34,45,2012,3,13.31859413
199,111,88,10,31.16,40,2012,3,12.86822145
245,151,94,11,31.16,40,2012,3,6.0032
276,180,96,12,31.98,40,2012,3,12.998
254,175,79,13,31.98,40,2012,3,11.0014
248,163,85,14,32.8,33,2012,3,7.0015
274,194,80,15,33.62,34,2012,3,15.0013
464,348,116,16,32.8,36,2012,3,6.0032
555,467,88,19,30.34,58,2012,3,11.0014
432,374,58,20,30.34,62,2012,3,15.0013
290,246,44,21,29.52,66,2012,3,12.998
192,148,44,22,29.52,62,2012,3,22.0028
128,100,28,23,28.7,70,2012,3,15.0013
60,48,12,0,28.7,74,2012,3,15.0013
27,19,8,1,27.88,79,2012,3,16.9979
11,9,2,2,27.88,83,2012,3,12.998
3,3,0,3,27.88,83,2012,3,12.998
5,5,0,4,27.88,83,2012,3,12.998
36,35,1,5,27.88,89,2012,3,12.998
64,63,1,6,26.24,83,2012,3,12.998
179,178,1,7,27.06,83,2012,3,6.0032
618,591,27,8,27.06,89,2012,3,6.0032
402,354,48,9,28.7,74,2012,3,13.09903526
208,155,53,10,28.7,79,2012,3,7.0015
196,127,69,11,30.34,62,2012,3,13.47701749
300,207,93,12,31.98,49,2012,3,8.9981
286,203,83,13,32.8,46,2012,3,6.0032
255,175,80,14,33.62,41,2012,3,15.0013
283,199,84,15,33.62,46,2012,3,15.0013
458,363,95,16,33.62,43,2012,3,15.0013
627,533,94,19,31.16,66,2012,3,12.998
436,371,65,20,30.34,74,2012,3,15.0013
308,252,56,21,30.34,62,2012,3,15.0013
189,161,28,22,29.52,66,2012,3,6.0032
167,114,53,23,29.52,66,2012,3,11.0014
60,52,8,0,28.7,61,2012,3,12.998
37,31,6,1,28.7,61,2012,3,13.38119917
8,7,1,2,27.88,65,2012,3,12.18870333
11,10,1,3,27.06,74,2012,3,7.0015
4,4,0,4,26.24,83,2012,3,7.0015
39,35,4,5,26.24,78,2012,3,7.0015
172,160,12,6,26.24,78,2012,3,7.0015
492,467,25,7,27.06,69,2012,3,12.998
682,642,40,8,28.7,65,2012,3,19.0012
367,310,57,9,29.52,62,2012,3,12.998
233,163,70,10,29.52,62,2012,3,12.998
235,155,80,11,30.34,58,2012,3,12.998
307,230,77,12,30.34,55,2012,3,15.0013
294,206,88,13,31.98,49,2012,3,12.998
255,161,94,14,31.16,52,2012,3,19.9995
266,196,70,15,31.16,52,2012,3,16.9979
431,340,91,16,31.16,48,2012,3,12.998
649,525,124,19,28.7,61,2012,3,8.9981
427,355,72,20,28.7,61,2012,3,8.9981
315,266,49,21,28.7,61,2012,3,12.998
226,197,29,22,28.7,61,2012,3,11.0014
138,120,18,23,27.88,65,2012,3,7.0015
76,63,13,0,27.06,69,2012,3,11.93041902
21,18,3,1,26.24,73,2012,3,11.63814036
15,15,0,2,26.24,69,2012,3,12.998
4,4,0,3,25.42,73,2012,3,16.9979
5,3,2,4,25.42,73,2012,3,15.0013
37,30,7,5,24.6,78,2012,3,11.0014
165,162,3,6,24.6,78,2012,3,11.0014
464,448,16,7,26.24,69,2012,3,15.0013
682,649,33,8,27.88,61,2012,3,12.998
337,296,41,9,29.52,54,2012,3,7.0015
199,121,78,10,30.34,48,2012,3,8.9981
274,191,83,11,31.16,37,2012,3,6.0032
343,247,96,12,32.8,33,2012,3,7.0015
300,219,81,13,32.8,31,2012,3,15.0013
248,176,72,14,33.62,32,2012,3,15.16212489
260,197,63,15,32.8,33,2012,3,16.9979
419,340,79,16,33.62,32,2012,3,15.0013
677,558,119,19,31.16,40,2012,3,7.0015
514,414,100,20,31.16,40,2012,3,6.0032
356,273,83,21,30.34,48,2012,3,12.998
254,185,69,22,29.52,51,2012,3,11.0014
226,168,58,23,28.7,54,2012,3,7.0015
88,67,21,0,27.88,57,2012,3,11.0014
54,38,16,1,27.06,65,2012,3,7.0015
19,15,4,2,27.06,61,2012,3,8.9981
6,6,0,3,26.24,65,2012,3,7.0015
9,9,0,4,26.24,73,2012,3,11.0014
36,34,2,5,26.24,73,2012,3,7.0015
157,151,6,6,25.42,78,2012,3,8.9981
379,368,11,7,26.24,73,2012,3,7.0015
668,625,43,8,27.88,65,2012,3,8.9981
378,320,58,9,28.7,58,2012,3,7.0015
231,149,82,10,30.34,55,2012,3,11.0014
303,205,98,11,31.16,52,2012,3,19.0012
365,255,110,12,33.62,41,2012,3,15.0013
357,254,103,13,34.44,36,2012,3,26.0027
328,200,128,14,35.26,34,2012,3,27.9993
383,256,127,15,35.26,30,2012,3,31.0009
488,372,116,16,34.44,32,2012,3,30.0026
669,561,108,18,33.62,38,2012,3,16.9979
491,403,88,19,30.34,55,2012,3,26.0027
359,262,97,20,29.52,58,2012,3,15.0013
255,198,57,21,27.88,69,2012,3,19.9995
213,170,43,22,27.06,83,2012,3,12.998
121,100,21,23,26.24,83,2012,3,15.0013
105,99,6,0,26.24,83,2012,3,15.0013
92,78,14,1,25.42,94,2012,3,11.0014
43,39,4,2,25.42,88,2012,3,11.0014
30,23,7,3,25.42,88,2012,3,12.998
13,8,5,4,25.42,73,2012,3,15.0013
9,7,2,5,24.6,78,2012,3,16.9979
27,23,4,6,24.6,83,2012,3,15.0013
64,52,12,7,24.6,83,2012,3,15.0013
189,161,28,8,26.24,69,2012,3,16.9979
292,211,81,9,27.06,65,2012,3,19.0012
480,314,166,10,28.7,54,2012,3,11.0014
536,356,180,11,29.52,51,2012,3,13.52460238
654,388,266,12,31.16,37,2012,3,12.998
644,355,289,13,30.34,40,2012,3,12.998
598,356,242,14,31.16,37,2012,3,19.0012
596,346,250,15,31.16,37,2012,3,15.0013
641,354,287,16,31.16,37,2012,3,16.9979
635,379,256,17,31.16,37,2012,3,15.0013
554,329,225,18,30.34,37,2012,3,11.0014
488,324,164,19,28.7,45,2012,3,11.0014
341,242,99,20,28.7,45,2012,3,7.0015
338,248,90,21,27.06,61,2012,3,13.30382478
261,171,90,22,27.06,61,2012,3,13.30382478
235,175,60,23,26.24,65,2012,3,6.0032
187,143,44,0,27.06,57,2012,3,6.0032
131,102,29,1,26.24,65,2012,3,11.84001136
119,103,16,2,25.42,69,2012,3,6.0032
55,34,21,3,25.42,61,2012,3,11.0014
26,22,4,4,25.42,65,2012,3,11.0014
11,8,3,5,24.6,73,2012,3,8.9981
20,15,5,6,25.42,69,2012,3,7.0015
41,29,12,7,25.42,69,2012,3,8.9981
124,90,34,8,26.24,69,2012,3,7.0015
270,184,86,9,27.06,74,2012,3,12.70724877
425,287,138,10,27.88,69,2012,3,13.19483988
272,189,83,11,26.24,78,2012,3,11.0014
298,186,112,12,26.24,73,2012,3,15.15243485
162,112,50,13,26.24,83,2012,3,8.9981
149,108,41,14,26.24,73,2012,3,15.15243485
276,187,89,15,26.24,65,2012,3,13.32960089
356,259,97,16,27.06,65,2012,3,13.25654904
343,267,76,17,26.24,78,2012,3,7.0015
377,291,86,18,26.24,78,2012,3,7.0015
341,269,72,19,26.24,73,2012,3,8.9981
274,213,61,20,26.24,73,2012,3,12.998
190,154,36,21,25.42,78,2012,3,6.0032
56,50,6,22,25.42,78,2012,3,11.0014
46,39,7,23,25.42,73,2012,3,12.51819522
168,146,22,0,30.34,62,2012,3,7.0015
79,68,11,1,29.52,74,2012,3,8.9981
69,61,8,2,28.7,70,2012,3,11.0014
35,29,6,3,28.7,70,2012,3,7.0015
12,9,3,4,28.7,70,2012,3,12.32870903
22,20,2,5,27.88,79,2012,3,10.86162041
36,23,13,6,27.88,79,2012,3,10.86162041
66,58,8,7,30.34,58,2012,3,8.9981
162,134,28,8,31.16,58,2012,3,16.9979
237,175,62,9,31.16,58,2012,3,12.998
417,289,128,10,31.98,55,2012,3,12.998
492,273,219,11,32.8,55,2012,3,15.0013
471,284,187,12,32.8,55,2012,3,11.0014
504,267,237,13,33.62,52,2012,3,6.0032
514,274,240,14,35.26,44,2012,3,11.0014
563,306,257,15,35.26,44,2012,3,19.0012
462,253,209,16,34.44,49,2012,3,11.0014
463,258,205,17,33.62,52,2012,3,15.78798095
442,258,184,18,33.62,52,2012,3,15.78798095
392,235,157,19,31.98,62,2012,3,18.81492949
207,140,67,20,31.16,67,2012,3,16.9979
104,83,21,21,26.24,89,2012,3,14.35827084
78,57,21,22,27.06,89,2012,3,11.58927789
145,88,57,23,27.06,89,2012,3,6.0032
99,72,27,0,27.06,89,2012,3,6.0032
73,58,15,1,27.06,89,2012,3,10.27700276
84,56,28,2,27.06,89,2012,3,10.27700276
42,33,9,3,27.06,89,2012,3,6.0032
22,15,7,4,27.06,89,2012,3,10.27700276
12,10,2,5,27.06,89,2012,3,10.27700276
15,13,2,6,27.06,89,2012,3,11.58927789
42,29,13,7,27.06,94,2012,3,6.0032
129,99,30,8,27.88,89,2012,3,6.0032
232,144,88,9,28.7,84,2012,3,12.41019877
388,230,158,10,29.52,79,2012,3,14.10741805
489,263,226,11,30.34,70,2012,3,13.6175298
545,297,248,12,30.34,70,2012,3,14.7777497
493,230,263,13,29.52,74,2012,3,6.0032
457,208,249,14,29.52,79,2012,3,6.0032
355,176,179,15,30.34,74,2012,3,8.9981
474,252,222,16,30.34,70,2012,3,13.56500161
503,284,219,17,31.16,66,2012,3,6.0032
500,273,227,18,30.34,74,2012,3,13.42101287
292,152,140,19,28.7,84,2012,3,15.0013
104,41,63,20,28.7,84,2012,3,11.0014
171,92,79,21,28.7,70,2012,3,11.0014
166,100,66,22,27.88,83,2012,3,8.9981
123,70,53,23,27.06,89,2012,3,6.0032
104,62,42,0,27.06,94,2012,3,11.53533637
55,37,18,1,27.88,89,2012,3,11.0014
40,30,10,2,27.06,89,2012,3,7.0015
28,22,6,3,27.06,89,2012,3,8.9981
11,5,6,4,27.06,89,2012,3,6.0032
4,3,1,5,27.06,89,2012,3,10.27700276
15,12,3,6,27.06,94,2012,3,9.321462266
43,37,6,7,27.88,85,2012,3,10.39392835
127,91,36,8,28.7,84,2012,3,7.0015
229,158,71,9,28.7,84,2012,3,8.9981
359,224,135,10,30.34,74,2012,3,15.0013
459,272,187,11,30.34,70,2012,3,19.0012
543,352,191,12,31.16,62,2012,3,19.9995
566,357,209,13,31.16,66,2012,3,16.9979
512,349,163,14,30.34,70,2012,3,19.9995
449,281,168,15,30.34,70,2012,3,15.0013
500,335,165,16,30.34,70,2012,3,15.0013
498,317,181,17,30.34,70,2012,3,8.9981
482,337,145,18,30.34,66,2012,3,11.0014
374,301,73,19,29.52,74,2012,3,12.998
261,183,78,20,29.52,76,2012,3,7.0015
184,142,42,21,29.52,76,2012,3,7.0015
121,104,17,22,28.7,84,2012,3,8.9981
70,58,12,23,28.7,84,2012,3,16.9979
29,19,10,0,28.7,84,2012,3,16.9979
24,9,15,1,27.88,82,2012,3,8.9981
5,4,1,2,27.88,82,2012,3,8.9981
10,9,1,3,27.06,89,2012,3,6.0032
8,8,0,4,27.06,89,2012,3,11.58927789
38,37,1,5,27.06,89,2012,3,11.58927789
172,165,7,6,27.88,89,2012,3,7.0015
493,480,13,7,27.88,89,2012,3,7.0015
632,617,15,8,28.7,84,2012,3,11.0014
323,293,30,9,29.52,79,2012,3,15.0013
172,130,42,10,29.52,74,2012,3,16.9979
198,159,39,11,30.34,70,2012,3,19.0012
287,233,54,12,31.16,70,2012,3,19.0012
275,203,72,13,32.8,55,2012,3,30.0026
274,202,72,14,32.8,55,2012,3,27.9993
292,224,68,15,32.8,59,2012,3,31.0009
458,397,61,16,31.16,70,2012,3,27.9993
552,502,50,19,31.16,70,2012,3,15.0013
385,338,47,20,30.34,70,2012,3,16.9979
268,240,28,21,30.34,74,2012,3,16.9979
179,154,25,22,30.34,70,2012,3,19.0012
95,83,12,23,29.52,74,2012,3,19.9995
37,27,10,0,29.52,74,2012,3,16.9979
13,11,2,1,28.7,84,2012,3,12.998
9,9,0,2,28.7,84,2012,3,12.998
4,4,0,3,28.7,79,2012,3,19.0012
5,3,2,4,28.7,79,2012,3,19.0012
40,39,1,5,28.7,79,2012,3,19.9995
210,203,7,6,28.7,79,2012,3,19.0012
500,489,11,7,28.7,79,2012,3,16.9979
725,692,33,8,29.52,74,2012,3,12.998
290,263,27,9,30.34,70,2012,3,16.9979
235,181,54,10,31.16,70,2012,3,11.0014
217,156,61,11,31.98,62,2012,3,11.0014
266,217,49,12,31.98,70,2012,3,7.0015
234,184,50,13,32.8,63,2012,3,11.0014
211,177,34,14,33.62,56,2012,3,7.0015
245,204,41,15,31.98,70,2012,3,12.998
430,344,86,16,31.16,70,2012,3,16.9979
662,598,64,19,30.34,70,2012,3,11.0014
412,357,55,20,29.52,84,2012,3,11.0014
296,278,18,21,29.52,79,2012,3,10.55732742
219,181,38,22,29.52,79,2012,3,10.55732742
150,126,24,23,28.7,84,2012,3,6.0032
65,35,30,0,28.7,84,2012,3,6.0032
18,16,2,1,28.7,84,2012,3,12.41019877
8,7,1,2,29.52,79,2012,3,10.55732742
9,9,0,3,28.7,84,2012,3,7.0015
8,8,0,4,28.7,84,2012,3,6.0032
38,35,3,5,28.7,84,2012,3,12.998
200,189,11,6,28.7,84,2012,3,6.0032
482,461,21,7,28.7,84,2012,3,7.0015
646,622,24,8,28.7,79,2012,3,14.93265705
123,115,8,9,27.06,94,2012,3,8.9981
49,40,9,10,27.06,94,2012,3,8.9981
62,52,10,11,28.7,84,2012,3,11.0014
137,126,11,12,29.52,79,2012,3,15.0013
191,152,39,13,29.52,79,2012,3,7.0015
216,178,38,14,30.34,74,2012,3,6.0032
270,228,42,15,30.34,66,2012,3,12.998
416,374,42,16,30.34,70,2012,3,15.0013
558,504,54,19,27.88,74,2012,3,16.9979
406,356,50,20,27.06,78,2012,3,15.0013
272,240,32,21,26.24,89,2012,3,11.0014
217,193,24,22,26.24,89,2012,3,11.0014
169,150,19,23,26.24,89,2012,3,11.0014
96,79,17,0,26.24,89,2012,3,8.9981
29,19,10,1,25.42,88,2012,3,7.0015
11,10,1,2,25.42,83,2012,3,6.0032
9,9,0,3,25.42,83,2012,3,6.0032
8,7,1,4,25.42,88,2012,3,10.07438866
40,39,1,5,25.42,88,2012,3,10.07438866
140,135,5,6,25.42,88,2012,3,7.0015
486,465,21,7,26.24,89,2012,3,7.0015
719,690,29,8,27.06,83,2012,3,7.0015
344,311,33,9,28.7,79,2012,3,8.9981
224,171,53,10,29.52,74,2012,3,8.9981
296,215,81,11,31.16,62,2012,3,8.9981
323,247,76,12,31.98,59,2012,3,11.0014
354,283,71,13,32.8,59,2012,3,16.9979
253,187,66,14,32.8,59,2012,3,16.9979
331,265,66,15,32.8,55,2012,3,16.9979
470,395,75,16,32.8,55,2012,3,19.0012
568,498,70,19,30.34,62,2012,3,19.0012
391,340,51,20,29.52,66,2012,3,15.0013
301,246,55,21,28.7,74,2012,3,11.0014
299,247,52,22,28.7,74,2012,3,15.0013
248,220,28,23,27.06,89,2012,3,16.9979
150,130,20,0,27.06,89,2012,3,16.9979
117,107,10,1,27.06,89,2012,3,19.0012
77,68,9,2,27.06,89,2012,3,22.0028
43,40,3,3,27.06,89,2012,3,15.0013
11,8,3,4,27.06,94,2012,3,15.0013
15,13,2,5,27.06,94,2012,3,16.9979
34,26,8,6,27.06,89,2012,3,19.0012
82,71,11,7,27.06,89,2012,3,19.0012
230,197,33,8,28.7,79,2012,3,22.0028
348,261,87,9,28.7,74,2012,3,26.0027
422,322,100,10,30.34,70,2012,3,26.0027
578,405,173,11,31.16,62,2012,3,30.0026
694,474,220,12,32.8,55,2012,3,32.9975
668,435,233,13,33.62,52,2012,3,35.0008
626,366,260,14,33.62,52,2012,3,30.0026
512,337,175,15,22.96,88,2012,3,16.9979
114,95,19,16,22.96,88,2012,3,12.998
171,119,52,17,23.78,83,2012,3,12.998
167,140,27,18,23.78,83,2012,3,8.9981
215,187,28,19,23.78,88,2012,3,7.0015
194,166,28,20,23.78,88,2012,3,6.0032
181,155,26,21,24.6,83,2012,3,11.0014
194,176,18,22,23.78,78,2012,3,19.9995
133,121,12,23,23.78,73,2012,3,11.0014
124,106,18,0,22.96,73,2012,3,12.998
124,104,20,1,22.96,73,2012,3,15.0013
96,81,15,2,22.14,77,2012,3,19.0012
46,32,14,3,22.14,73,2012,3,15.0013
28,16,12,4,21.32,77,2012,3,16.9979
55,39,16,5,21.32,77,2012,3,12.998
35,24,11,6,21.32,77,2012,3,12.998
70,50,20,7,22.14,73,2012,3,11.0014
170,143,27,8,23.78,68,2012,3,15.0013
299,214,85,9,25.42,61,2012,3,16.9979
495,323,172,10,26.24,57,2012,3,19.9995
585,391,194,11,27.06,47,2012,3,16.9979
729,491,238,13,27.88,39,2012,3,15.04510537
647,415,232,14,29.52,30,2012,3,19.0012
696,412,284,15,29.52,32,2012,3,16.9979
701,473,228,16,27.88,36,2012,3,19.0012
671,458,213,17,28.7,37,2012,3,16.9979
560,404,156,18,27.06,36,2012,3,16.9979
496,362,134,19,27.06,36,2012,3,16.9979
356,265,91,20,25.42,41,2012,3,19.0012
206,149,57,21,24.6,46,2012,3,15.0013
189,125,64,22,23.78,49,2012,3,16.9979
92,70,22,23,22.96,52,2012,3,19.0012
41,35,6,0,22.96,52,2012,3,19.0012
18,11,7,1,22.14,60,2012,3,12.998
17,6,11,2,22.14,60,2012,3,23.9994
12,7,5,3,21.32,68,2012,3,19.0012
5,4,1,4,21.32,68,2012,3,19.0012
40,36,4,5,20.5,72,2012,3,16.9979
180,172,8,6,20.5,72,2012,3,8.9981
447,427,20,7,21.32,68,2012,3,15.0013
730,697,33,8,22.96,60,2012,3,19.0012
361,321,40,9,24.6,53,2012,3,19.9995
210,168,42,10,25.42,50,2012,3,19.0012
236,167,69,11,25.42,43,2012,3,19.9995
332,256,76,12,26.24,44,2012,3,26.0027
323,251,72,13,26.24,38,2012,3,15.0013
340,233,107,14,27.06,36,2012,3,19.0012
346,231,115,15,27.06,31,2012,3,26.0027
488,380,108,16,27.06,34,2012,3,22.0028
633,562,71,19,25.42,38,2012,3,19.9995
390,356,34,20,24.6,40,2012,3,12.998
285,256,29,21,22.96,49,2012,3,11.0014
159,144,15,22,22.14,52,2012,3,8.9981
93,86,7,23,22.14,52,2012,3,15.88035982
32,27,5,0,21.32,59,2012,3,7.0015
10,10,0,1,20.5,63,2012,3,13.80583497
6,5,1,2,19.68,77,2012,3,11.0014
8,7,1,3,19.68,67,2012,3,8.9981
9,8,1,4,19.68,72,2012,3,7.0015
44,41,3,5,18.86,72,2012,3,6.0032
211,200,11,6,18.86,77,2012,3,7.0015
596,572,24,7,20.5,72,2012,3,7.0015
358,323,35,9,24.6,49,2012,3,15.72522774
196,142,54,10,25.42,38,2012,3,16.63614988
247,187,60,11,26.24,33,2012,3,6.0032
316,254,62,12,26.24,33,2012,3,16.1057584
328,256,72,13,27.06,29,2012,3,6.0032
255,181,74,14,27.88,30,2012,3,6.0032
326,253,73,15,28.7,28,2012,3,7.0015
536,437,99,16,28.7,28,2012,3,8.9981
596,540,56,19,25.42,41,2012,3,12.998
461,421,40,20,23.78,56,2012,3,8.9981
310,282,28,21,22.96,60,2012,3,7.0015
216,189,27,22,22.96,64,2012,3,7.0015
109,91,18,23,22.14,68,2012,3,7.0015
49,41,8,0,21.32,72,2012,3,7.0015
21,19,2,1,21.32,72,2012,3,7.0015
11,9,2,2,21.32,72,2012,3,6.0032
7,7,0,3,20.5,77,2012,3,6.0032
5,5,0,4,20.5,72,2012,3,6.0032
48,44,4,5,20.5,72,2012,3,6.0032
205,199,6,6,20.5,72,2012,3,6.0032
557,533,24,7,21.32,72,2012,3,11.16926515
328,278,50,9,24.6,64,2012,3,8.9981
205,148,57,10,25.42,61,2012,3,8.9981
232,181,51,11,27.06,50,2012,3,12.998
352,264,88,12,27.88,36,2012,3,8.9981
323,238,85,13,28.7,34,2012,3,8.9981
278,200,78,14,28.7,37,2012,3,11.0014
318,243,75,15,29.52,37,2012,3,8.9981
509,419,90,16,29.52,37,2012,3,11.0014
635,557,78,19,26.24,50,2012,3,12.998
470,432,38,20,25.42,57,2012,3,8.9981
306,279,27,21,24.6,60,2012,3,8.9981
212,189,23,22,22.96,64,2012,3,6.0032
127,111,16,23,22.96,68,2012,3,7.0015
57,46,11,0,22.96,73,2012,3,6.0032
28,22,6,1,22.14,77,2012,3,6.0032
9,9,0,2,22.14,77,2012,3,10.85902315
11,9,2,3,21.32,83,2012,3,10.56704507
6,6,0,4,21.32,83,2012,3,10.56704507
57,54,3,5,21.32,83,2012,3,10.56704507
195,186,9,6,20.5,82,2012,3,10.55868527
571,549,22,7,22.14,77,2012,3,10.85902315
338,292,46,9,24.6,64,2012,3,6.0032
212,149,63,10,26.24,61,2012,3,6.0032
254,183,71,11,27.06,50,2012,3,11.0014
297,240,57,12,27.88,44,2012,3,7.0015
283,223,60,13,28.7,42,2012,3,13.94370397
274,214,60,14,29.52,39,2012,3,8.9981
352,253,99,15,29.52,42,2012,3,7.0015
491,406,85,16,29.52,39,2012,3,6.0032
674,594,80,19,26.24,65,2012,3,8.9981
463,408,55,20,25.42,69,2012,3,7.0015
317,291,26,21,25.42,65,2012,3,7.0015
251,223,28,22,24.6,69,2012,3,8.9981
170,137,33,23,23.78,73,2012,3,7.0015
87,63,24,0,22.96,73,2012,3,6.0032
41,35,6,1,22.96,73,2012,3,6.0032
30,23,7,2,22.96,73,2012,3,11.99800388
14,9,5,3,22.14,77,2012,3,10.85902315
12,11,1,4,22.14,77,2012,3,10.85902315
41,40,1,5,22.14,83,2012,3,10.62875901
152,144,8,6,22.14,88,2012,3,10.17542732
454,437,17,7,22.96,88,2012,3,11.48334318
347,301,46,9,25.42,78,2012,3,11.0014
246,171,75,10,27.88,65,2012,3,13.6135155
280,196,84,11,27.88,61,2012,3,7.0015
409,290,119,12,28.7,54,2012,3,12.998
408,301,107,13,28.7,54,2012,3,12.998
371,258,113,14,29.52,45,2012,3,11.0014
367,273,94,15,29.52,48,2012,3,8.9981
563,454,109,16,29.52,51,2012,3,13.7581755
579,496,83,19,27.88,57,2012,3,11.0014
404,337,67,20,27.06,61,2012,3,7.0015
312,270,42,21,26.24,73,2012,3,15.0013
229,189,40,22,25.42,83,2012,3,12.998
195,168,27,23,25.42,78,2012,3,6.0032
207,169,38,0,24.6,83,2012,3,7.0015
109,101,8,1,24.6,73,2012,3,12.05723144
93,75,18,2,23.78,78,2012,3,7.0015
37,31,6,3,24.6,73,2012,3,16.9979
6,3,3,4,24.6,69,2012,3,23.9994
16,15,1,5,23.78,60,2012,3,35.0008
33,27,6,6,22.14,49,2012,3,27.9993
73,63,10,7,22.14,52,2012,3,19.0012
212,169,43,8,22.96,49,2012,3,27.9993
342,263,79,9,24.6,43,2012,3,27.9993
442,323,119,10,25.42,41,2012,3,26.0027
627,399,228,11,26.24,38,2012,3,26.0027
706,419,287,12,27.06,36,2012,3,23.9994
704,377,327,13,27.88,36,2012,3,12.998
715,390,325,14,27.88,34,2012,3,22.0028
654,342,312,15,27.88,34,2012,3,19.0012
729,434,295,17,27.06,36,2012,3,16.9979
614,382,232,18,26.24,36,2012,3,19.0012
478,309,169,19,25.42,41,2012,3,11.0014
330,241,89,20,24.6,43,2012,3,6.0032
296,210,86,21,22.96,52,2012,3,7.0015
279,197,82,22,22.96,52,2012,3,15.70806578
229,182,47,23,22.14,60,2012,3,13.80364261
151,123,28,0,22.14,64,2012,3,12.53064018
117,82,35,1,22.14,64,2012,3,12.53064018
89,62,27,2,21.32,63,2012,3,13.80383544
48,38,10,3,20.5,68,2012,3,11.36547509
8,6,2,4,20.5,72,2012,3,11.03620614
13,10,3,5,20.5,72,2012,3,11.03620614
35,26,9,6,20.5,72,2012,3,11.03620614
71,43,28,7,20.5,77,2012,3,7.0015
128,94,34,8,22.14,64,2012,3,11.0014
296,226,70,9,23.78,60,2012,3,8.9981
490,330,160,10,25.42,50,2012,3,7.0015
559,376,183,11,26.24,47,2012,3,11.0014
656,468,188,12,27.06,44,2012,3,11.0014
694,454,240,13,26.24,41,2012,3,11.0014
635,410,225,14,27.06,39,2012,3,8.9981
557,342,215,15,26.24,41,2012,3,11.0014
596,402,194,16,26.24,44,2012,3,11.0014
570,393,177,17,27.06,41,2012,3,15.71319847
481,361,120,18,25.42,50,2012,3,11.0014
403,312,91,19,25.42,50,2012,3,8.9981
324,267,57,20,24.6,53,2012,3,7.0015
191,148,43,21,24.6,56,2012,3,7.0015
127,109,18,22,22.96,68,2012,3,6.0032
94,85,9,23,22.14,68,2012,3,7.0015
45,31,14,0,22.14,68,2012,3,11.0014
21,12,9,1,21.32,72,2012,3,6.0032
13,8,5,2,21.32,72,2012,3,11.16926515
7,7,0,3,20.5,77,2012,3,6.0032
11,9,2,4,20.5,77,2012,3,10.70599913
45,44,1,5,19.68,82,2012,3,6.0032
164,157,7,6,19.68,82,2012,3,10.50105625
492,474,18,7,21.32,77,2012,3,10.75178323
683,647,36,8,22.14,77,2012,3,6.0032
299,265,34,9,23.78,68,2012,3,8.9981
202,129,73,10,25.42,65,2012,3,12.998
252,191,61,11,25.42,69,2012,3,15.0013
295,233,62,12,25.42,69,2012,3,12.998
343,231,112,13,26.24,65,2012,3,16.9979
332,203,129,14,26.24,65,2012,3,16.9979
338,256,82,15,26.24,65,2012,3,16.9979
453,379,74,16,26.24,69,2012,3,16.9979
486,435,51,19,25.42,73,2012,3,7.0015
340,308,32,20,25.42,73,2012,3,8.9981
233,205,28,21,25.42,83,2012,3,15.0013
129,109,20,22,25.42,83,2012,3,16.9979
70,66,4,23,24.6,94,2012,3,16.9979
13,11,2,0,24.6,94,2012,3,16.9979
5,5,0,1,24.6,94,2012,3,12.998
4,4,0,2,24.6,94,2012,3,12.998
6,6,0,3,25.42,94,2012,3,19.0012
7,5,2,4,25.42,94,2012,3,23.9994
48,45,3,5,26.24,89,2012,3,22.0028
167,163,4,6,26.24,89,2012,3,22.0028
356,343,13,7,26.24,89,2012,3,30.0026
672,640,32,8,27.06,83,2012,3,36.9974
293,266,27,9,27.06,83,2012,3,39.0007
160,130,30,10,27.88,79,2012,3,43.0006
151,115,36,11,27.88,79,2012,3,43.0006
88,72,16,12,27.88,83,2012,3,30.0026
114,97,17,13,28.7,74,2012,3,39.0007
143,116,27,14,24.6,94,2012,3,31.0009
36,35,1,15,24.6,88,2012,3,16.9979
141,122,19,16,24.6,88,2012,3,19.9995
338,302,36,17,24.6,88,2012,3,12.998
281,262,19,18,24.6,88,2012,3,11.0014
324,302,22,19,24.6,88,2012,3,19.9995
290,271,19,20,24.6,88,2012,3,12.998
207,186,21,21,24.6,88,2012,3,12.998
151,137,14,22,23.78,83,2012,3,31.0009
78,67,11,23,22.96,83,2012,3,15.0013
26,23,3,0,22.96,68,2012,3,19.0012
12,12,0,1,22.14,68,2012,3,16.9979
3,3,0,2,22.14,64,2012,3,22.0028
5,4,1,3,21.32,63,2012,3,16.9979
10,10,0,4,21.32,68,2012,3,23.9994
56,54,2,5,21.32,68,2012,3,19.0012
172,166,6,6,21.32,63,2012,3,16.9979
545,529,16,7,21.32,63,2012,3,15.0013
362,336,26,9,22.14,60,2012,3,16.9979
192,169,23,10,22.96,52,2012,3,12.998
247,203,44,11,24.6,43,2012,3,16.9979
313,260,53,12,24.6,43,2012,3,16.9979
289,234,55,13,24.6,40,2012,3,16.9979
286,227,59,14,25.42,38,2012,3,16.9979
311,254,57,15,25.42,35,2012,3,16.70804148
466,397,69,16,25.42,35,2012,3,16.70804148
611,539,72,19,22.96,43,2012,3,15.0013
409,378,31,20,21.32,48,2012,3,11.0014
349,324,25,21,20.5,59,2012,3,11.0014
229,198,31,22,20.5,63,2012,3,6.0032
123,106,17,23,19.68,67,2012,3,6.0032
45,39,6,0,18.86,72,2012,4,7.0015
18,13,5,1,18.04,77,2012,4,6.0032
12,6,6,2,18.86,72,2012,4,11.25369725
7,6,1,3,18.04,77,2012,4,10.85696307
10,10,0,4,17.22,82,2012,4,7.0015
36,34,2,5,18.04,77,2012,4,10.85696307
155,147,8,6,18.04,77,2012,4,7.0015
483,470,13,7,18.04,77,2012,4,11.0014
340,314,26,9,21.32,63,2012,4,14.3897451
179,135,44,10,22.14,56,2012,4,14.61591736
272,196,76,11,23.78,46,2012,4,15.81774057
323,262,61,12,24.6,43,2012,4,11.0014
305,225,80,13,24.6,43,2012,4,11.0014
244,193,51,14,24.6,43,2012,4,7.0015
329,234,95,15,25.42,43,2012,4,8.9981
459,408,51,16,25.42,46,2012,4,16.9979
613,571,42,18,22.96,64,2012,4,7.0015
516,483,33,19,22.14,68,2012,4,7.0015
262,251,11,20,22.14,68,2012,4,17.08125326
218,205,13,21,22.14,73,2012,4,8.9981
207,190,17,22,22.14,77,2012,4,6.0032
105,88,17,23,22.14,77,2012,4,14.72313006
31,30,1,0,22.96,73,2012,4,13.46761733
11,11,0,1,22.14,77,2012,4,7.0015
2,2,0,2,22.14,77,2012,4,7.0015
5,4,1,3,22.14,88,2012,4,12.998
10,8,2,4,22.96,83,2012,4,6.0032
43,42,1,5,22.96,83,2012,4,8.9981
179,176,3,6,23.78,83,2012,4,7.0015
260,256,4,7,23.78,83,2012,4,7.0015
134,128,6,8,24.6,88,2012,4,13.75685936
86,83,3,9,23.78,88,2012,4,8.9981
45,42,3,10,23.78,88,2012,4,8.9981
99,92,7,11,23.78,94,2012,4,8.9981
104,98,6,12,24.6,88,2012,4,12.998
154,148,6,13,24.6,88,2012,4,8.9981
163,147,16,14,24.6,88,2012,4,8.9981
209,195,14,15,25.42,83,2012,4,8.9981
374,328,46,16,25.42,88,2012,4,8.9981
715,677,38,17,25.42,88,2012,4,7.0015
687,639,48,18,25.42,94,2012,4,6.0032
395,368,27,19,25.42,94,2012,4,8.588751096
306,286,20,20,25.42,94,2012,4,8.9981
289,265,24,21,25.42,94,2012,4,7.0015
240,212,28,22,25.42,94,2012,4,7.0015
98,87,11,23,25.42,94,2012,4,10.84578826
52,47,5,0,25.42,94,2012,4,8.588751096
19,16,3,1,25.42,94,2012,4,10.84578826
9,7,2,2,25.42,94,2012,4,10.84578826
7,7,0,3,24.6,94,2012,4,10.78471825
11,9,2,4,24.6,100,2012,4,10.64353446
34,32,2,5,25.42,94,2012,4,7.0015
177,173,4,6,24.6,94,2012,4,8.9981
515,504,11,7,24.6,94,2012,4,12.998
362,332,30,9,25.42,83,2012,4,12.998
175,146,29,10,27.06,78,2012,4,11.0014
230,178,52,11,27.06,78,2012,4,11.0014
358,289,69,12,28.7,70,2012,4,7.0015
279,224,55,13,28.7,74,2012,4,7.0015
251,195,56,14,29.52,70,2012,4,11.0014
319,260,59,15,29.52,62,2012,4,11.0014
478,436,42,16,29.52,58,2012,4,14.52010573
593,544,49,19,28.7,65,2012,4,12.41336698
497,449,48,20,28.7,65,2012,4,12.41336698
209,195,14,21,27.06,74,2012,4,13.28418028
241,232,9,22,27.06,74,2012,4,12.4300047
220,199,21,23,27.06,78,2012,4,13.18961413
76,65,11,0,26.24,89,2012,4,13.63556528
25,23,2,1,25.42,94,2012,4,10.84578826
13,10,3,2,26.24,89,2012,4,11.73531225
11,6,5,3,25.42,88,2012,4,10.98366255
10,10,0,4,26.24,89,2012,4,11.326195
39,37,2,5,26.24,89,2012,4,7.0015
133,132,1,6,25.42,94,2012,4,6.0032
391,379,12,7,26.24,89,2012,4,6.0032
359,319,40,9,26.24,89,2012,4,12.998
177,150,27,10,27.06,83,2012,4,8.9981
214,176,38,11,28.7,70,2012,4,7.0015
288,231,57,12,29.52,54,2012,4,12.998
294,231,63,13,29.52,58,2012,4,22.0028
267,211,56,14,28.7,61,2012,4,16.9979
325,248,77,15,29.52,54,2012,4,19.0012
497,411,86,16,28.7,54,2012,4,19.0012
534,467,67,19,27.06,57,2012,4,7.0015
441,391,50,20,26.24,65,2012,4,7.0015
321,288,33,21,25.42,69,2012,4,12.05753161
232,203,29,22,26.24,47,2012,4,8.9981
155,137,18,23,24.6,56,2012,4,6.0032
102,86,16,0,22.96,73,2012,4,12.44637599
46,43,3,1,22.14,68,2012,4,7.0015
11,10,1,2,22.14,73,2012,4,6.0032
16,11,5,3,22.14,73,2012,4,12.1998327
11,11,0,4,22.14,77,2012,4,11.78421486
41,41,0,5,21.32,77,2012,4,11.31685843
137,133,4,6,21.32,83,2012,4,11.46921028
428,417,11,7,21.32,83,2012,4,7.0015
384,326,58,9,24.6,60,2012,4,6.0032
260,192,68,10,27.06,54,2012,4,14.36078664
304,214,90,11,28.7,48,2012,4,12.998
468,307,161,12,29.52,42,2012,4,11.0014
424,307,117,13,28.7,48,2012,4,13.56167719
400,287,113,14,30.34,37,2012,4,15.0013
470,320,150,15,29.52,39,2012,4,16.9979
634,481,153,16,29.52,37,2012,4,13.66366516
500,433,67,19,25.42,73,2012,4,11.0014
372,306,66,20,24.6,78,2012,4,8.9981
267,220,47,21,24.6,69,2012,4,15.0013
264,201,63,22,24.6,73,2012,4,19.0012
171,148,23,23,23.78,78,2012,4,15.0013
191,154,37,0,22.96,83,2012,4,11.0014
141,116,25,1,22.96,83,2012,4,16.9979
75,62,13,2,22.96,78,2012,4,12.998
56,54,2,3,22.14,77,2012,4,15.0013
11,7,4,4,22.14,83,2012,4,16.9979
10,8,2,5,22.14,83,2012,4,12.998
30,28,2,6,22.14,88,2012,4,16.9979
84,71,13,7,22.14,83,2012,4,19.9995
206,184,22,8,22.96,83,2012,4,12.998
395,265,130,9,24.6,73,2012,4,12.998
539,341,198,10,25.42,69,2012,4,19.0012
647,389,258,11,26.24,65,2012,4,16.9979
710,400,310,13,26.24,57,2012,4,35.0008
576,307,269,14,24.6,56,2012,4,27.9993
620,341,279,15,24.6,46,2012,4,27.9993
659,342,317,16,24.6,43,2012,4,35.0008
610,342,268,17,22.14,49,2012,4,26.0027
495,312,183,18,21.32,48,2012,4,27.9993
341,239,102,19,19.68,55,2012,4,15.0013
247,172,75,20,19.68,55,2012,4,16.9979
215,137,78,21,18.86,59,2012,4,8.9981
185,140,45,22,18.04,62,2012,4,8.9981
179,142,37,23,18.04,62,2012,4,8.9981
127,99,28,0,18.04,62,2012,4,11.0014
109,80,29,1,18.04,54,2012,4,15.0013
74,64,10,2,17.22,62,2012,4,8.9981
22,17,5,3,18.04,62,2012,4,8.9981
11,6,5,4,18.04,54,2012,4,16.9979
10,8,2,5,18.04,54,2012,4,8.9981
23,19,4,6,18.04,54,2012,4,12.998
35,29,6,7,17.22,58,2012,4,11.0014
62,51,11,8,17.22,67,2012,4,8.9981
86,70,16,9,16.4,71,2012,4,8.9981
185,144,41,10,17.22,67,2012,4,12.998
336,260,76,11,17.22,71,2012,4,7.0015
392,292,100,12,17.22,71,2012,4,13.63428592
320,240,80,13,18.04,72,2012,4,6.0032
314,243,71,14,18.04,67,2012,4,14.11862109
306,232,74,15,17.22,77,2012,4,8.9981
333,246,87,16,16.4,82,2012,4,11.0014
157,122,35,17,16.4,82,2012,4,15.0013
106,82,24,18,16.4,82,2012,4,12.998
114,97,17,19,16.4,82,2012,4,7.0015
116,97,19,20,16.4,82,2012,4,8.9981
113,91,22,21,15.58,87,2012,4,7.0015
79,72,7,22,15.58,87,2012,4,8.9981
80,68,12,23,14.76,93,2012,4,8.9981
51,44,7,0,15.58,76,2012,4,19.0012
37,35,2,1,13.94,87,2012,4,11.0014
15,12,3,2,13.94,81,2012,4,12.998
10,8,2,3,13.94,81,2012,4,7.0015
7,6,1,4,13.12,87,2012,4,8.9981
19,17,2,5,13.94,76,2012,4,15.0013
59,54,5,6,13.94,76,2012,4,7.0015
154,151,3,7,13.94,76,2012,4,11.0014
397,374,23,8,14.76,71,2012,4,15.0013
332,273,59,9,15.58,66,2012,4,11.0014
298,229,69,10,15.58,68,2012,4,8.9981
308,236,72,11,16.4,62,2012,4,6.0032
341,267,74,12,17.22,63,2012,4,11.0014
405,323,82,13,17.22,62,2012,4,12.998
420,299,121,14,17.22,58,2012,4,7.0015
370,294,76,15,17.22,58,2012,4,12.998
377,316,61,16,17.22,58,2012,4,12.998
497,416,81,17,17.22,66,2012,4,16.9979
456,415,41,18,17.22,66,2012,4,19.0012
371,333,38,19,16.4,71,2012,4,16.9979
227,207,20,20,16.4,71,2012,4,15.0013
151,134,17,21,16.4,76,2012,4,15.0013
107,101,6,22,16.4,76,2012,4,16.9979
69,60,9,23,16.4,71,2012,4,15.0013
31,22,9,0,15.58,82,2012,4,15.0013
13,13,0,1,14.76,87,2012,4,15.0013
7,5,2,2,14.76,87,2012,4,16.9979
3,3,0,3,14.76,87,2012,4,19.0012
7,6,1,4,14.76,87,2012,4,11.0014
19,19,0,5,15.58,82,2012,4,12.998
143,141,2,6,15.58,82,2012,4,16.9979
362,357,5,7,15.58,83,2012,4,16.9979
713,698,15,8,17.22,80,2012,4,12.998
382,345,37,9,17.22,77,2012,4,15.0013
164,131,33,10,18.04,75,2012,4,15.0013
193,156,37,11,19.68,69,2012,4,12.998
260,217,43,12,19.68,69,2012,4,12.998
238,184,54,13,20.5,67,2012,4,8.9981
244,201,43,14,22.14,64,2012,4,12.998
254,195,59,15,21.32,63,2012,4,11.0014
424,354,70,16,20.5,72,2012,4,11.0014
514,483,31,19,20.5,72,2012,4,11.0014
360,330,30,20,20.5,72,2012,4,11.0014
225,209,16,21,19.68,77,2012,4,8.9981
162,155,7,22,19.68,77,2012,4,6.0032
84,76,8,23,19.68,77,2012,4,6.0032
33,33,0,0,18.86,88,2012,4,6.0032
8,6,2,1,18.86,88,2012,4,10.86752957
8,6,2,2,18.86,88,2012,4,10.86752957
6,6,0,3,18.86,88,2012,4,10.86752957
6,6,0,4,18.86,88,2012,4,7.0015
40,38,2,5,18.86,88,2012,4,6.0032
175,172,3,6,18.86,88,2012,4,6.0032
507,498,9,7,18.86,82,2012,4,7.0015
366,331,35,9,22.14,60,2012,4,19.0012
217,190,27,10,22.96,52,2012,4,19.9995
291,238,53,11,22.14,52,2012,4,12.998
390,312,78,12,22.14,56,2012,4,15.0013
297,237,60,13,22.96,49,2012,4,15.98041146
271,208,63,14,24.6,40,2012,4,11.0014
319,261,58,15,24.6,40,2012,4,11.0014
566,474,92,16,24.6,40,2012,4,15.0013
566,534,32,19,22.96,46,2012,4,39.0007
392,371,21,20,21.32,48,2012,4,32.9975
269,251,18,21,20.5,51,2012,4,23.9994
197,170,27,22,18.86,55,2012,4,19.9995
136,119,17,23,18.04,58,2012,4,12.998
42,41,1,0,18.04,51,2012,4,8.9981
11,10,1,1,18.04,47,2012,4,12.998
11,7,4,2,17.22,50,2012,4,8.9981
3,3,0,3,17.22,47,2012,4,19.9995
10,10,0,4,16.4,50,2012,4,16.9979
42,42,0,5,14.76,50,2012,4,11.0014
159,158,1,6,14.76,50,2012,4,11.0014
478,467,11,7,14.76,50,2012,4,16.9979
355,328,27,9,16.4,43,2012,4,26.0027
204,165,39,10,18.04,41,2012,4,23.9994
251,175,76,11,18.86,36,2012,4,16.18966576
326,279,47,12,18.86,36,2012,4,16.18966576
291,243,48,13,20.5,31,2012,4,7.0015
348,270,78,14,21.32,32,2012,4,6.0032
460,358,102,15,21.32,34,2012,4,11.0014
481,413,68,16,20.5,36,2012,4,8.9981
692,628,64,18,18.86,44,2012,4,11.0014
415,388,27,20,17.22,62,2012,4,11.0014
260,236,24,21,17.22,62,2012,4,8.9981
177,167,10,22,16.4,66,2012,4,11.0014
186,176,10,23,17.22,58,2012,4,6.0032
68,60,8,0,16.4,66,2012,4,7.0015
37,29,8,1,16.4,66,2012,4,6.0032
16,16,0,2,16.4,66,2012,4,6.0032
6,6,0,3,14.76,76,2012,4,6.0032
8,8,0,4,14.76,76,2012,4,7.0015
35,33,2,5,14.76,81,2012,4,6.0032
143,140,3,6,13.94,81,2012,4,6.0032
392,384,8,7,14.76,81,2012,4,6.0032
400,374,26,9,20.5,39,2012,4,19.9995
275,200,75,10,21.32,36,2012,4,19.9995
313,252,61,11,22.14,37,2012,4,23.9994
387,312,75,12,22.14,39,2012,4,31.0009
381,300,81,13,22.96,37,2012,4,26.0027
371,262,109,14,22.96,37,2012,4,31.0009
455,317,138,15,21.32,42,2012,4,30.0026
520,412,108,16,18.86,41,2012,4,23.9994
642,566,76,18,18.04,38,2012,4,19.9995
493,453,40,19,17.22,41,2012,4,15.0013
308,280,28,20,17.22,47,2012,4,8.9981
190,169,21,21,16.4,54,2012,4,12.998
160,143,17,22,16.4,47,2012,4,19.9995
100,89,11,23,14.76,57,2012,4,12.998
249,218,31,0,14.76,57,2012,4,6.0032
146,123,23,1,13.94,53,2012,4,8.9981
67,60,7,2,13.94,53,2012,4,12.998
15,13,2,3,13.12,66,2012,4,15.0013
11,9,2,4,12.3,65,2012,4,11.0014
11,11,0,5,12.3,61,2012,4,12.998
28,23,5,6,12.3,61,2012,4,12.998
70,60,10,7,12.3,61,2012,4,11.0014
174,151,23,8,13.94,53,2012,4,7.0015
266,220,46,9,14.76,50,2012,4,6.0032
347,265,82,10,16.4,43,2012,4,16.00175087
527,335,192,11,17.22,35,2012,4,8.9981
573,371,202,12,18.04,35,2012,4,16.15275356
670,435,235,13,18.86,36,2012,4,12.998
597,354,243,14,19.68,33,2012,4,12.998
615,364,251,15,20.5,36,2012,4,12.998
637,343,294,16,20.5,31,2012,4,12.998
528,335,193,17,18.86,38,2012,4,11.0014
473,299,174,18,18.86,44,2012,4,8.9981
332,259,73,19,18.04,44,2012,4,11.0014
255,198,57,20,16.4,54,2012,4,6.0032
204,157,47,21,16.4,58,2012,4,12.998
189,156,33,22,16.4,62,2012,4,13.8577711
125,98,27,23,17.22,58,2012,4,19.9995
111,103,8,0,16.4,71,2012,4,16.9979
112,96,16,1,17.22,77,2012,4,19.0012
66,58,8,2,16.4,76,2012,4,6.0032
28,25,3,3,17.22,77,2012,4,19.9995
12,10,2,4,17.22,77,2012,4,19.0012
11,6,5,5,16.4,82,2012,4,12.998
24,20,4,6,16.4,82,2012,4,11.0014
51,44,7,7,17.22,82,2012,4,15.0013
132,104,28,8,18.04,77,2012,4,12.998
223,161,62,9,19.68,67,2012,4,19.0012
428,278,150,10,22.14,56,2012,4,12.998
494,338,156,11,22.96,52,2012,4,19.9995
562,362,200,12,25.42,46,2012,4,22.0028
619,401,218,13,26.24,41,2012,4,30.0026
617,368,249,14,27.06,39,2012,4,27.9993
568,355,213,15,27.06,39,2012,4,27.9993
581,378,203,16,26.24,41,2012,4,19.9995
539,346,193,17,26.24,44,2012,4,12.998
453,319,134,18,23.78,60,2012,4,16.9979
336,268,68,19,22.96,64,2012,4,15.0013
246,198,48,20,22.14,73,2012,4,15.0013
196,156,40,21,22.96,73,2012,4,30.0026
125,87,38,22,22.96,73,2012,4,26.0027
105,78,27,23,22.96,68,2012,4,19.0012
48,31,17,0,22.96,73,2012,4,16.9979
29,24,5,1,23.78,64,2012,4,26.0027
6,5,1,2,23.78,64,2012,4,23.9994
4,2,2,3,22.96,73,2012,4,16.9979
10,9,1,4,22.96,68,2012,4,15.0013
40,38,2,5,22.96,73,2012,4,19.0012
147,141,6,6,22.96,73,2012,4,19.9995
476,461,15,7,23.78,68,2012,4,22.0028
359,328,31,9,24.6,69,2012,4,26.0027
168,125,43,10,24.6,73,2012,4,26.0027
263,175,88,11,24.6,73,2012,4,26.0027
284,211,73,12,24.6,78,2012,4,22.0028
146,109,37,13,22.96,88,2012,4,15.0013
185,128,57,14,24.6,78,2012,4,19.0012
260,190,70,15,24.6,78,2012,4,22.0028
447,371,76,16,22.96,64,2012,4,19.9995
592,540,52,18,22.14,77,2012,4,8.9981
239,227,12,19,21.32,83,2012,4,6.0032
256,237,19,20,21.32,72,2012,4,26.0027
206,190,16,21,21.32,59,2012,4,22.0028
126,118,8,22,20.5,59,2012,4,19.0012
81,72,9,23,18.86,63,2012,4,15.0013
48,45,3,0,18.86,63,2012,4,26.0027
13,9,4,1,18.04,67,2012,4,12.998
3,1,2,2,18.04,67,2012,4,8.9981
2,2,0,3,17.22,67,2012,4,7.0015
7,7,0,4,17.22,67,2012,4,11.0014
52,47,5,5,17.22,67,2012,4,16.9979
172,168,4,6,17.22,67,2012,4,11.0014
525,505,20,7,17.22,67,2012,4,6.0032
355,323,32,9,19.68,55,2012,4,16.9979
222,157,65,10,20.5,48,2012,4,19.0012
228,172,56,11,20.5,45,2012,4,27.9993
325,256,69,12,21.32,45,2012,4,22.0028
328,260,68,13,21.32,45,2012,4,19.0012
308,214,94,14,22.14,39,2012,4,16.9979
346,270,76,15,22.14,41,2012,4,22.0028
446,367,79,16,22.14,39,2012,4,19.0012
531,491,40,19,19.68,48,2012,4,16.06924229
432,397,35,20,18.86,55,2012,4,14.59845777
195,176,19,21,18.86,63,2012,4,13.9182098
181,163,18,22,16.4,71,2012,4,6.0032
199,176,23,23,16.4,71,2012,4,11.23078075
49,48,1,0,15.58,76,2012,4,10.142951
17,14,3,1,15.58,76,2012,4,10.142951
16,12,4,2,15.58,76,2012,4,10.142951
7,7,0,3,14.76,87,2012,4,9.155070862
4,4,0,4,14.76,81,2012,4,6.0032
41,39,2,5,14.76,81,2012,4,11.40682498
178,171,7,6,15.58,82,2012,4,9.935865552
464,449,15,7,14.76,81,2012,4,7.0015
382,344,38,9,17.22,77,2012,4,11.94585195
228,168,60,10,18.86,67,2012,4,14.17675759
234,156,78,11,20.5,51,2012,4,6.0032
332,261,71,12,21.32,48,2012,4,11.0014
310,237,73,13,22.14,49,2012,4,8.9981
270,188,82,14,22.96,43,2012,4,11.0014
301,239,62,15,23.78,43,2012,4,15.0013
466,396,70,16,22.96,52,2012,4,12.998
516,467,49,19,20.5,72,2012,4,12.998
414,360,54,20,20.5,72,2012,4,8.9981
329,301,28,21,18.86,82,2012,4,12.998
215,198,17,22,18.86,88,2012,4,16.9979
99,84,15,23,18.86,88,2012,4,15.0013
57,53,4,0,18.86,88,2012,4,12.998
14,14,0,1,18.86,82,2012,4,15.0013
14,13,1,2,18.86,82,2012,4,12.998
5,5,0,3,18.04,88,2012,4,15.0013
5,5,0,4,18.04,88,2012,4,15.0013
42,41,1,5,18.04,82,2012,4,15.0013
153,150,3,6,18.04,88,2012,4,19.9995
508,488,20,7,18.04,88,2012,4,16.9979
387,346,41,9,20.5,77,2012,4,11.0014
218,158,60,10,21.32,68,2012,4,15.0013
268,189,79,11,22.96,56,2012,4,15.0013
377,284,93,12,24.6,53,2012,4,16.9979
332,236,96,13,25.42,53,2012,4,23.9994
285,191,94,14,25.42,50,2012,4,19.9995
353,284,69,15,24.6,60,2012,4,12.998
450,356,94,16,24.6,56,2012,4,19.0012
513,471,42,19,22.96,68,2012,4,19.9995
387,348,39,20,22.96,68,2012,4,16.9979
283,245,38,21,22.14,77,2012,4,12.998
229,202,27,22,22.14,83,2012,4,12.998
117,111,6,23,22.14,83,2012,4,11.67952034
56,51,5,0,22.96,83,2012,4,7.0015
16,12,4,1,22.14,88,2012,4,14.40877774
10,9,1,2,22.14,88,2012,4,11.26999095
5,5,0,3,22.96,83,2012,4,11.6482436
6,5,1,4,22.96,83,2012,4,11.6482436
36,35,1,5,22.14,88,2012,4,11.26999095
131,126,5,6,22.14,94,2012,4,11.0014
154,149,5,7,22.14,94,2012,4,15.46378597
467,447,20,8,22.14,94,2012,4,7.0015
389,363,26,9,22.14,94,2012,4,7.0015
224,198,26,10,23.78,88,2012,4,12.998
252,211,41,11,24.6,83,2012,4,12.998
332,258,74,12,26.24,69,2012,4,15.0013
375,288,87,13,25.42,73,2012,4,15.0013
365,277,88,14,27.06,61,2012,4,16.9979
395,302,93,15,26.24,65,2012,4,19.9995
565,434,131,16,25.42,69,2012,4,23.9994
425,377,48,17,25.42,69,2012,4,23.9994
233,212,21,18,22.96,83,2012,4,7.0015
232,213,19,19,22.14,88,2012,4,11.0014
229,216,13,20,21.32,77,2012,4,12.998
206,189,17,21,20.5,77,2012,4,11.15739295
190,176,14,22,20.5,77,2012,4,6.0032
131,118,13,23,18.86,88,2012,4,7.0015
60,52,8,0,14.76,57,2012,4,6.0032
30,22,8,1,12.3,75,2012,4,7.0015
20,10,10,2,13.12,66,2012,4,8.9981
15,10,5,3,13.94,61,2012,4,8.9981
10,8,2,4,13.94,66,2012,4,7.0015
40,39,1,5,13.94,66,2012,4,8.9981
148,146,2,6,13.94,61,2012,4,11.0014
420,414,6,7,14.76,57,2012,4,11.0014
680,668,12,8,14.76,56,2012,4,7.0015
331,310,21,9,14.76,57,2012,4,7.0015
146,133,13,10,14.76,62,2012,4,12.998
170,156,14,11,14.76,62,2012,4,12.998
221,198,23,12,15.58,62,2012,4,11.0014
248,199,49,13,16.4,58,2012,4,11.0014
185,154,31,14,16.4,50,2012,4,15.0013
214,179,35,15,16.4,54,2012,4,11.0014
344,313,31,16,16.4,54,2012,4,11.0014
689,652,37,17,16.4,50,2012,4,15.0013
678,628,50,18,16.4,50,2012,4,11.0014
452,424,28,19,16.4,50,2012,4,11.0014
296,280,16,20,15.58,54,2012,4,16.9979
267,238,29,21,15.58,54,2012,4,8.9981
202,175,27,22,14.76,57,2012,4,11.0014
120,112,8,23,13.94,57,2012,4,11.0014
50,40,10,0,13.94,57,2012,4,11.0014
24,19,5,1,13.12,66,2012,4,11.0014
10,7,3,2,13.12,66,2012,4,11.0014
3,3,0,3,12.3,70,2012,4,11.0014
7,6,1,4,12.3,70,2012,4,7.0015
26,25,1,5,13.12,66,2012,4,11.0014
122,120,2,6,12.3,70,2012,4,11.0014
357,349,8,7,12.3,70,2012,4,8.9981
687,656,31,8,13.12,57,2012,4,7.0015
382,355,27,9,13.94,53,2012,4,7.0015
204,183,21,10,15.58,46,2012,4,19.9995
221,179,42,11,17.22,41,2012,4,27.9993
292,240,52,12,17.22,41,2012,4,23.9994
294,230,64,13,16.4,43,2012,4,23.9994
262,199,63,14,16.4,40,2012,4,32.9975
306,255,51,15,16.4,40,2012,4,27.9993
421,373,48,16,15.58,40,2012,4,22.0028
638,581,57,17,15.58,40,2012,4,22.0028
522,490,32,18,15.58,43,2012,4,22.0028
374,336,38,19,15.58,43,2012,4,19.9995
221,207,14,20,14.76,46,2012,4,27.9993
156,133,23,21,14.76,46,2012,4,23.9994
149,135,14,22,14.76,46,2012,4,16.9979
119,108,11,23,13.94,53,2012,4,19.9995
108,99,9,0,13.94,53,2012,4,11.0014
89,83,6,1,13.94,49,2012,4,22.0028
46,36,10,2,13.94,49,2012,4,16.9979
28,22,6,3,13.94,49,2012,4,16.9979
16,8,8,4,13.12,49,2012,4,19.9995
9,8,1,5,13.12,49,2012,4,16.9979
21,17,4,6,13.12,49,2012,4,12.998
59,58,1,7,13.12,49,2012,4,16.9979
142,132,10,8,13.94,46,2012,4,19.9995
219,188,31,9,13.94,49,2012,4,19.9995
328,260,68,10,14.76,46,2012,4,26.0027
340,284,56,11,14.76,46,2012,4,26.0027
394,320,74,12,14.76,46,2012,4,31.0009
449,339,110,13,14.76,46,2012,4,23.9994
455,319,136,14,14.76,50,2012,4,22.0028
448,331,117,15,14.76,46,2012,4,30.0026
400,292,108,16,14.76,46,2012,4,22.0028
410,298,112,17,14.76,46,2012,4,19.9995
297,239,58,18,14.76,46,2012,4,19.0012
239,217,22,19,14.76,50,2012,4,11.0014
181,158,23,20,13.94,53,2012,4,8.9981
166,135,31,21,13.94,53,2012,4,7.0015
146,133,13,22,13.12,57,2012,4,7.0015
148,133,15,23,13.12,57,2012,4,7.0015
102,97,5,0,12.3,61,2012,4,7.0015
165,139,26,1,10.66,81,2012,4,6.0032
37,31,6,2,12.3,65,2012,4,9.361462079
11,10,1,3,11.48,61,2012,4,7.0015
9,7,2,4,10.66,65,2012,4,8.9981
5,5,0,5,10.66,65,2012,4,7.0015
16,14,2,6,11.48,61,2012,4,8.9981
50,39,11,7,10.66,65,2012,4,7.0015
149,115,34,8,12.3,56,2012,4,8.9981
217,161,56,9,13.12,53,2012,4,9.243556566
360,287,73,10,13.94,49,2012,4,12.998
445,311,134,11,15.58,46,2012,4,15.0013
504,354,150,12,15.58,46,2012,4,15.0013
493,371,122,13,16.4,43,2012,4,15.0013
509,360,149,14,16.4,40,2012,4,12.998
449,300,149,15,16.4,40,2012,4,15.0013
435,316,119,16,16.4,40,2012,4,22.0028
327,270,57,17,14.76,43,2012,4,12.998
237,206,31,18,14.76,43,2012,4,15.0013
227,203,24,19,14.76,43,2012,4,16.9979
141,134,7,20,13.12,53,2012,4,23.9994
87,71,16,21,12.3,52,2012,4,19.9995
79,64,15,22,12.3,52,2012,4,19.0012
53,41,12,23,12.3,56,2012,4,11.0014
23,20,3,0,12.3,56,2012,4,12.998
8,8,0,1,12.3,56,2012,4,11.0014
6,4,2,2,12.3,56,2012,4,11.0014
4,3,1,3,12.3,56,2012,4,15.0013
16,11,5,4,12.3,52,2012,4,16.9979
39,38,1,5,12.3,52,2012,4,22.0028
139,135,4,6,12.3,49,2012,4,19.0012
461,453,8,7,12.3,49,2012,4,16.9979
648,629,19,8,12.3,49,2012,4,15.0013
257,239,18,9,12.3,52,2012,4,19.0012
142,112,30,10,13.12,49,2012,4,19.0012
150,119,31,11,13.94,46,2012,4,15.0013
244,206,38,12,14.76,43,2012,4,22.0028
222,183,39,13,14.76,40,2012,4,16.9979
196,165,31,14,15.58,40,2012,4,11.0014
231,207,24,15,15.58,40,2012,4,19.0012
360,325,35,16,14.76,43,2012,4,19.0012
638,604,34,17,13.94,46,2012,4,15.0013
542,523,19,18,13.94,46,2012,4,15.0013
372,361,11,19,13.12,49,2012,4,11.0014
241,228,13,20,13.12,49,2012,4,16.9979
152,144,8,21,12.3,52,2012,4,19.0012
115,111,4,22,11.48,56,2012,4,12.998
53,53,0,23,10.66,60,2012,4,8.9981
19,18,1,0,9.84,60,2012,4,7.0015
8,8,0,1,9.84,60,2012,4,11.0014
2,2,0,2,9.84,65,2012,4,6.0032
4,4,0,3,9.02,64,2012,4,7.0015
7,7,0,4,9.02,69,2012,4,6.0032
41,40,1,5,9.02,64,2012,4,12.998
149,143,6,6,9.02,69,2012,4,8.9981
387,378,9,7,8.2,69,2012,4,11.0014
588,568,20,8,9.02,69,2012,4,11.0014
363,338,25,9,10.66,60,2012,4,11.0014
230,189,41,10,12.3,49,2012,4,12.998
216,177,39,11,13.12,45,2012,4,8.9981
248,217,31,12,13.12,45,2012,4,8.9981
278,232,46,13,13.94,46,2012,4,8.9981
240,196,44,14,14.76,40,2012,4,7.0015
272,227,45,15,13.94,46,2012,4,16.9979
402,369,33,16,13.94,46,2012,4,11.0014
627,597,30,17,13.12,53,2012,4,15.0013
497,477,20,18,13.12,57,2012,4,19.9995
371,356,15,19,12.3,56,2012,4,15.0013
228,218,10,20,12.3,61,2012,4,15.0013
151,137,14,21,12.3,56,2012,4,16.9979
153,136,17,22,12.3,56,2012,4,15.0013
205,186,19,23,12.3,56,2012,4,15.0013
283,234,49,0,12.3,56,2012,4,19.0012
92,86,6,1,11.48,61,2012,4,16.9979
74,68,6,2,11.48,56,2012,4,19.9995
11,9,2,3,11.48,52,2012,4,22.0028
9,9,0,4,11.48,52,2012,4,19.9995
27,27,0,5,11.48,52,2012,4,22.0028
118,115,3,6,10.66,56,2012,4,19.0012
319,314,5,7,10.66,56,2012,4,19.9995
601,583,18,8,10.66,60,2012,4,19.0012
368,351,17,9,10.66,60,2012,4,19.0012
178,151,27,10,11.48,56,2012,4,19.9995
147,132,15,11,13.12,51,2012,4,23.9994
212,188,24,12,13.12,53,2012,4,19.0012
181,158,23,13,13.12,53,2012,4,16.9979
161,142,19,14,13.12,53,2012,4,23.9994
198,178,20,15,13.12,53,2012,4,19.9995
273,250,23,16,13.12,53,2012,4,23.9994
517,501,16,17,13.12,53,2012,4,26.0027
465,448,17,18,13.12,53,2012,4,23.9994
319,302,17,19,12.3,56,2012,4,19.9995
256,249,7,20,13.12,49,2012,4,22.0028
126,121,5,21,13.12,49,2012,4,19.9995
60,56,4,22,12.3,56,2012,4,16.9979
40,37,3,23,11.48,65,2012,4,15.0013
15,14,1,0,11.48,61,2012,4,15.0013
12,11,1,1,12.3,52,2012,4,23.9994
6,5,1,2,12.3,49,2012,4,15.0013
10,9,1,4,12.3,45,2012,4,19.0012
35,35,0,5,12.3,42,2012,4,15.0013
124,122,2,6,12.3,39,2012,4,15.0013
423,411,12,7,11.48,36,2012,4,26.0027
668,652,16,8,12.3,33,2012,4,19.0012
275,253,22,9,13.12,31,2012,4,23.9994
161,148,13,10,13.12,31,2012,4,22.0028
171,155,16,11,14.76,29,2012,4,26.0027
235,202,33,12,16.4,24,2012,4,32.9975
228,195,33,13,18.04,18,2012,4,27.9993
182,149,33,14,18.04,18,2012,4,27.9993
233,201,32,15,18.04,18,2012,4,27.9993
339,321,18,16,17.22,16,2012,4,26.0027
592,556,36,17,16.4,20,2012,4,19.9995
507,491,16,18,16.4,24,2012,4,27.9993
373,359,14,19,15.58,27,2012,4,23.9994
245,235,10,20,15.58,29,2012,4,31.0009
233,222,11,21,14.76,37,2012,4,26.0027
161,147,14,22,13.94,42,2012,4,19.9995
87,82,5,23,13.94,46,2012,4,23.9994
55,46,9,0,13.94,49,2012,4,22.0028
20,17,3,1,13.12,53,2012,4,19.0012
12,11,1,2,13.12,53,2012,4,16.9979
9,6,3,3,13.12,53,2012,4,27.9993
14,14,0,4,13.12,53,2012,4,23.9994
27,25,2,5,12.3,56,2012,4,12.998
131,126,5,6,10.66,65,2012,4,7.0015
341,332,9,7,10.66,65,2012,4,8.9981
693,668,25,8,13.12,57,2012,4,11.0014
327,304,23,9,13.94,53,2012,4,27.9993
197,163,34,10,14.76,50,2012,4,22.0028
251,185,66,11,16.4,47,2012,4,19.9995
262,214,48,12,18.04,41,2012,4,22.0028
299,237,62,13,18.86,38,2012,4,19.9995
274,207,67,14,18.86,38,2012,4,12.998
356,278,78,15,18.86,36,2012,4,15.0013
434,377,57,16,18.86,38,2012,4,11.0014
654,593,61,17,17.22,44,2012,4,8.9981
496,450,46,18,17.22,44,2012,4,7.0015
361,331,30,19,13.94,71,2012,4,6.0032
255,235,20,20,14.76,66,2012,4,8.9981
199,176,23,21,13.94,76,2012,4,8.022981483
163,146,17,22,13.94,71,2012,4,7.0015
162,142,20,23,13.12,81,2012,4,6.0032
122,106,16,0,13.12,76,2012,4,6.0032
76,68,8,1,12.3,81,2012,4,6.0032
44,42,2,2,13.12,81,2012,4,8.099270089
20,11,9,3,12.3,81,2012,4,8.24651117
6,4,2,4,10.66,87,2012,4,7.0015
10,9,1,5,11.48,87,2012,4,7.717600228
16,11,5,6,9.84,93,2012,4,6.0032
71,57,14,7,10.66,87,2012,4,7.0015
146,130,16,8,13.12,76,2012,4,8.178706165
259,216,43,9,14.76,66,2012,4,12.998
350,264,86,10,16.4,58,2012,4,13.98803874
466,323,143,11,16.4,58,2012,4,7.0015
606,348,258,12,19.68,48,2012,4,15.86130716
651,383,268,13,21.32,39,2012,4,16.53865613
627,347,280,14,22.14,37,2012,4,16.6597927
567,351,216,15,21.32,45,2012,4,15.82371022
605,378,227,16,22.14,37,2012,4,16.6597927
501,318,183,17,20.5,45,2012,4,12.998
359,256,103,18,18.04,54,2012,4,8.9981
283,228,55,19,18.86,51,2012,4,6.0032
192,153,39,20,18.04,54,2012,4,14.56034312
220,169,51,21,16.4,66,2012,4,11.40911031
193,154,39,22,15.58,71,2012,4,6.0032
146,120,26,23,14.76,71,2012,4,7.0015
124,110,14,0,13.94,81,2012,4,6.0032
108,82,26,1,13.94,76,2012,4,6.0032
70,58,12,2,13.12,87,2012,4,7.0015
48,39,9,3,13.94,81,2012,4,7.824138076
11,6,5,4,13.12,81,2012,4,7.0015
12,12,0,5,12.3,87,2012,4,8.9981
19,16,3,6,12.3,87,2012,4,6.0032
68,56,12,7,12.3,89,2012,4,6.0032
119,87,32,8,13.12,87,2012,4,7.0015
273,179,94,9,14.76,77,2012,4,9.737530527
405,272,133,10,16.4,69,2012,4,7.0015
504,324,180,11,18.86,59,2012,4,8.9981
585,390,195,12,20.5,48,2012,4,6.0032
686,424,262,13,22.14,45,2012,4,7.0015
654,362,292,14,24.6,33,2012,4,11.0014
724,420,304,15,22.96,37,2012,4,15.0013
653,393,260,16,22.14,42,2012,4,15.0013
493,342,151,17,22.14,45,2012,4,11.0014
405,303,102,18,21.32,45,2012,4,8.9981
277,208,69,19,19.68,55,2012,4,8.9981
200,146,54,20,18.04,62,2012,4,11.0014
171,127,44,21,18.04,67,2012,4,15.0013
134,113,21,22,17.22,71,2012,4,12.998
109,93,16,23,17.22,71,2012,4,12.998
49,43,6,0,17.22,71,2012,4,7.0015
30,26,4,1,16.4,76,2012,4,11.0014
20,14,6,2,16.4,76,2012,4,8.9981
4,3,1,3,16.4,76,2012,4,8.9981
4,3,1,4,16.4,76,2012,4,6.0032
24,23,1,5,15.58,87,2012,4,9.481177517
71,64,7,6,15.58,87,2012,4,7.0015
264,248,16,7,16.4,87,2012,4,9.483241932
540,490,50,8,17.22,82,2012,4,11.0014
397,337,60,9,18.04,88,2012,4,7.0015
266,184,82,10,19.68,77,2012,4,11.0014
367,255,112,11,21.32,72,2012,4,11.0014
419,314,105,12,22.96,64,2012,4,15.0013
420,312,108,13,24.6,60,2012,4,15.0013
444,310,134,14,23.78,60,2012,4,19.0012
382,280,102,15,22.96,64,2012,4,16.9979
434,347,87,16,22.96,64,2012,4,11.0014
596,530,66,17,22.96,64,2012,4,19.0012
551,486,65,18,21.32,72,2012,4,8.9981
353,323,30,19,22.14,73,2012,4,19.0012
304,273,31,20,21.32,77,2012,4,19.0012
155,145,10,21,22.14,73,2012,4,15.0013
112,100,12,22,21.32,77,2012,4,16.9979
63,62,1,23,22.14,77,2012,4,15.0013
23,18,5,0,21.32,83,2012,4,19.0012
5,5,0,1,18.04,88,2012,4,43.0006
11,4,7,2,14.76,87,2012,4,30.0026
5,3,2,3,14.76,87,2012,4,23.9994
9,9,0,4,14.76,81,2012,4,26.0027
18,18,0,5,13.94,87,2012,4,19.0012
50,48,2,6,13.12,81,2012,4,31.0009
107,106,1,7,13.12,87,2012,4,16.9979
211,207,4,8,13.12,87,2012,4,16.9979
110,109,1,9,13.12,81,2012,4,22.0028
94,84,10,10,12.3,75,2012,4,26.0027
155,133,22,11,13.12,70,2012,4,16.9979
196,180,16,12,13.94,61,2012,4,19.0012
218,188,30,13,13.94,53,2012,4,16.9979
203,169,34,14,15.58,46,2012,4,26.0027
217,184,33,15,16.4,40,2012,4,19.9995
310,282,28,16,15.58,40,2012,4,19.9995
608,575,33,17,13.94,49,2012,4,23.9994
559,514,45,18,13.94,49,2012,4,19.0012
356,344,12,19,13.12,49,2012,4,23.9994
223,211,12,20,12.3,49,2012,4,23.9994
187,178,9,21,12.3,49,2012,4,23.9994
135,120,15,22,10.66,56,2012,4,22.0028
84,78,6,23,10.66,56,2012,4,19.9995
24,20,4,0,10.66,56,2012,4,19.0012
12,10,2,1,9.84,60,2012,4,19.9995
1,1,0,2,9.84,60,2012,4,19.9995
5,5,0,3,9.84,65,2012,4,15.0013
6,6,0,4,9.02,69,2012,4,12.998
39,39,0,5,9.02,69,2012,4,12.998
146,142,4,6,9.84,65,2012,4,12.998
415,405,10,7,9.84,65,2012,4,19.0012
691,664,27,8,11.48,56,2012,4,19.9995
332,310,22,9,12.3,52,2012,4,26.0027
171,153,18,10,13.12,45,2012,4,23.9994
151,126,25,11,13.12,49,2012,4,16.9979
240,200,40,12,13.94,46,2012,4,11.0817772
214,182,32,13,14.76,43,2012,4,16.9979
181,161,20,14,14.76,43,2012,4,8.9981
260,228,32,15,14.76,43,2012,4,19.0012
321,290,31,16,13.94,46,2012,4,7.0015
583,564,19,17,13.12,49,2012,4,12.998
567,543,24,18,13.12,53,2012,4,11.0014
396,368,28,19,12.3,52,2012,4,11.0014
267,252,15,20,12.3,52,2012,4,6.0032
213,208,5,21,12.3,56,2012,4,10.11211451
173,167,6,22,11.48,61,2012,4,9.870605703
87,78,9,23,9.84,70,2012,4,8.9981
34,33,1,0,10.66,65,2012,4,10.02975532
16,14,2,1,10.66,65,2012,4,7.0015
7,7,0,2,10.66,70,2012,4,11.0014
2,2,0,3,10.66,70,2012,4,6.0032
5,5,0,4,11.48,65,2012,4,8.9981
37,34,3,5,12.3,61,2012,4,15.0013
147,146,1,6,12.3,65,2012,4,16.9979
410,403,7,7,12.3,65,2012,4,12.998
646,625,21,8,12.3,61,2012,4,15.0013
323,306,17,9,13.12,61,2012,4,12.998
153,142,11,10,13.12,66,2012,4,8.9981
166,138,28,11,13.94,61,2012,4,8.9981
213,184,29,12,14.76,62,2012,4,7.0015
217,197,20,13,15.58,54,2012,4,7.0015
201,174,27,14,15.58,54,2012,4,11.0014
217,191,26,15,15.58,58,2012,4,11.0014
342,318,24,16,14.76,57,2012,4,12.998
563,541,22,17,14.76,57,2012,4,15.0013
573,563,10,18,14.76,57,2012,4,12.998
386,375,11,19,13.94,61,2012,4,8.9981
285,262,23,20,13.94,61,2012,4,7.0015
224,204,20,21,13.12,66,2012,4,7.0015
153,143,10,22,13.12,66,2012,4,11.0014
125,118,7,23,13.12,61,2012,4,11.0014
65,58,7,0,13.12,66,2012,4,7.0015
21,16,5,1,12.3,65,2012,4,6.0032
9,9,0,2,12.3,70,2012,4,11.0014
6,6,0,3,12.3,65,2012,4,8.9981
5,5,0,4,12.3,65,2012,4,7.0015
36,34,2,5,12.3,65,2012,4,6.0032
130,126,4,6,12.3,61,2012,4,6.0032
367,362,5,7,12.3,61,2012,4,11.0014
711,694,17,8,13.12,57,2012,4,8.9981
351,330,21,9,13.94,53,2012,4,7.0015
198,165,33,10,13.94,53,2012,4,12.998
218,185,33,11,15.58,43,2012,4,15.0013
290,262,28,12,16.4,43,2012,4,19.0012
278,226,52,13,17.22,38,2012,4,12.998
251,204,47,14,17.22,35,2012,4,7.0015
267,237,30,15,17.22,38,2012,4,8.9981
383,350,33,16,17.22,35,2012,4,19.0012
580,539,41,17,14.76,46,2012,4,12.998
505,483,22,18,13.94,53,2012,4,11.0014
332,306,26,19,14.76,46,2012,4,15.0013
227,207,20,20,14.76,46,2012,4,16.9979
178,157,21,21,13.94,49,2012,4,12.998
162,139,23,22,13.12,53,2012,4,16.9979
128,114,14,23,13.12,53,2012,4,15.0013
106,95,11,0,12.3,52,2012,4,11.0014
87,74,13,1,10.66,60,2012,4,12.998
49,41,8,2,10.66,65,2012,4,12.998
21,19,2,3,10.66,65,2012,4,12.998
7,6,1,4,9.84,70,2012,4,12.998
11,10,1,5,9.84,70,2012,4,11.0014
21,21,0,6,9.84,70,2012,4,15.0013
78,70,8,7,9.84,70,2012,4,12.998
168,138,30,8,10.66,65,2012,4,15.0013
248,200,48,9,13.94,49,2012,4,15.0013
320,258,62,10,14.76,46,2012,4,16.9979
423,343,80,11,15.58,43,2012,4,12.998
476,359,117,12,16.4,40,2012,4,11.0014
525,346,179,13,17.22,38,2012,4,16.9979
555,380,175,14,17.22,38,2012,4,12.998
549,374,175,15,17.22,35,2012,4,19.9995
469,325,144,16,16.4,40,2012,4,15.0013
403,302,101,17,15.58,40,2012,4,11.0014
271,237,34,18,14.76,50,2012,4,7.0015
253,208,45,19,13.94,53,2012,4,6.0032
172,142,30,20,13.94,66,2012,4,6.0032
139,124,15,21,13.12,57,2012,4,7.0015
145,130,15,22,13.12,57,2012,4,7.0015
133,114,19,23,12.3,70,2012,4,7.0015
129,118,11,0,12.3,70,2012,4,11.0014
95,81,14,1,12.3,70,2012,4,12.998
73,65,8,2,11.48,81,2012,4,7.0015
46,37,9,3,12.3,81,2012,4,11.0014
12,8,4,4,12.3,81,2012,4,12.998
12,7,5,5,11.48,81,2012,4,8.9981
15,13,2,6,11.48,81,2012,4,11.0014
42,39,3,7,11.48,81,2012,4,12.998
119,100,19,8,12.3,75,2012,4,16.9979
204,155,49,9,13.12,70,2012,4,16.9979
329,250,79,10,13.94,66,2012,4,19.9995
359,267,92,11,15.58,62,2012,4,19.0012
442,341,101,12,16.4,62,2012,4,19.0012
447,334,113,13,16.4,62,2012,4,22.0028
428,303,125,14,16.4,62,2012,4,19.9995
407,318,89,15,17.22,54,2012,4,19.0012
372,313,59,16,16.4,62,2012,4,22.0028
280,232,48,17,15.58,66,2012,4,16.9979
276,240,36,18,14.76,66,2012,4,15.0013
210,194,16,19,14.76,66,2012,4,11.0014
129,120,9,20,14.76,66,2012,4,11.0014
110,93,17,21,14.76,66,2012,4,16.9979
74,66,8,22,14.76,66,2012,4,16.9979
59,53,6,23,14.76,66,2012,4,15.0013
27,22,5,0,14.76,66,2012,4,15.0013
19,19,0,1,14.76,66,2012,4,15.0013
5,5,0,2,14.76,66,2012,4,16.9979
2,2,0,3,14.76,66,2012,4,15.0013
12,11,1,4,14.76,66,2012,4,15.0013
39,38,1,5,14.76,66,2012,4,15.0013
131,128,3,6,14.76,66,2012,4,16.9979
386,381,5,7,14.76,66,2012,4,19.9995
663,650,13,8,14.76,66,2012,4,19.9995
278,260,18,9,14.76,66,2012,4,16.9979
139,106,33,10,14.76,66,2012,4,16.9979
197,164,33,11,15.58,66,2012,4,16.9979
242,207,35,12,16.4,62,2012,4,19.0012
251,205,46,13,18.04,54,2012,4,16.9979
217,170,47,14,18.04,54,2012,4,16.9979
257,213,44,15,18.04,54,2012,4,12.998
380,325,55,16,17.22,58,2012,4,16.9979
619,586,33,17,17.22,58,2012,4,12.998
580,559,21,18,16.4,58,2012,4,16.9979
406,381,25,19,16.4,58,2012,4,19.0012
259,252,7,20,15.58,62,2012,4,16.9979
203,188,15,21,15.58,54,2012,4,15.0013
113,106,7,22,13.94,66,2012,4,7.0015
74,72,2,23,13.94,66,2012,4,7.0015
108,99,9,0,10.66,81,2012,4,7.851103525
69,64,5,1,10.66,81,2012,4,7.851103525
50,47,3,2,10.66,81,2012,4,9.645887944
15,14,1,3,10.66,81,2012,4,8.9981
5,5,0,4,10.66,81,2012,4,6.0032
13,12,1,5,9.84,87,2012,4,6.0032
27,20,7,6,9.84,87,2012,4,8.9981
63,56,7,7,9.84,87,2012,4,8.9981
144,133,11,8,9.84,87,2012,4,8.9981
193,159,34,9,10.66,93,2012,4,16.9979
256,211,45,10,11.48,89,2012,4,11.0014
392,318,74,11,13.12,76,2012,4,7.0015
446,327,119,12,13.12,81,2012,4,6.0032
509,386,123,13,13.94,76,2012,4,10.34436432
479,369,110,14,14.76,71,2012,4,12.07542902
484,371,113,15,16.4,62,2012,4,14.22914088
443,354,89,16,15.58,66,2012,4,12.73955748
320,270,50,17,13.94,76,2012,4,7.0015
297,255,42,18,13.94,76,2012,4,10.34436432
249,219,30,19,13.12,81,2012,4,9.641569878
198,170,28,20,13.12,81,2012,4,8.156397631
158,135,23,21,12.3,87,2012,4,9.317516552
147,130,17,22,12.3,87,2012,4,9.317516552
126,116,10,23,13.12,81,2012,4,9.641569878
117,108,9,0,12.3,87,2012,4,6.0032
94,84,10,1,12.3,87,2012,4,6.0032
74,72,2,2,12.3,87,2012,4,9.317516552
25,21,4,3,10.66,93,2012,4,9.074482676
7,6,1,4,10.66,93,2012,4,9.074482676
8,7,1,5,10.66,93,2012,4,9.074482676
16,15,1,6,9.84,93,2012,4,8.9981
31,26,5,7,9.84,93,2012,4,8.9981
93,81,12,8,10.66,93,2012,4,6.0032
172,135,37,9,11.48,93,2012,4,11.0014
293,230,63,10,12.3,87,2012,4,9.317516552
355,274,81,11,13.12,81,2012,4,11.0014
520,409,111,12,13.94,81,2012,4,11.0014
431,347,84,13,16.4,71,2012,4,15.0013
473,331,142,14,18.04,62,2012,4,16.9979
417,311,106,15,18.04,67,2012,4,8.9981
443,358,85,16,18.04,67,2012,4,7.0015
303,244,59,17,16.4,76,2012,4,12.998
203,178,25,18,18.04,72,2012,4,7.0015
174,158,16,19,16.4,82,2012,4,12.998
154,142,12,20,17.22,82,2012,4,12.998
99,91,8,21,18.04,77,2012,4,15.0013
96,85,11,22,18.04,77,2012,4,12.998
51,44,7,23,17.22,82,2012,4,8.9981
21,18,3,0,17.22,82,2012,4,11.0014
13,11,2,1,16.4,82,2012,4,8.9981
10,9,1,2,17.22,77,2012,4,11.0014
8,6,2,3,15.58,87,2012,4,9.534675336
5,4,1,4,14.76,93,2012,4,8.897074344
38,38,0,5,13.94,93,2012,4,6.0032
138,136,2,6,14.76,93,2012,4,8.897074344
396,387,9,7,13.94,93,2012,4,8.414699867
731,712,19,8,14.76,93,2012,4,8.897074344
308,289,19,9,16.4,87,2012,4,6.0032
136,105,31,10,18.04,77,2012,4,8.9981
233,182,51,11,19.68,77,2012,4,8.9981
268,228,40,12,21.32,68,2012,4,11.0014
321,240,81,13,23.78,56,2012,4,6.0032
260,209,51,14,24.6,53,2012,4,16.54950055
268,210,58,15,24.6,56,2012,4,14.8780261
442,397,45,16,24.6,53,2012,4,8.9981
708,665,43,17,21.32,63,2012,4,7.0015
692,666,26,18,20.5,68,2012,4,6.0032
471,444,27,19,20.5,68,2012,4,6.0032
300,284,16,20,18.86,77,2012,4,12.24380851
221,207,14,21,18.04,82,2012,4,12.998
144,139,5,22,17.22,82,2012,4,7.0015
102,93,9,23,17.22,82,2012,4,7.0015
55,49,6,0,17.22,88,2012,4,7.0015
25,22,3,1,17.22,82,2012,4,7.0015
8,5,3,2,17.22,88,2012,4,6.0032
4,3,1,3,16.4,87,2012,4,8.9981
7,7,0,4,16.4,87,2012,4,8.9981
46,45,1,5,18.04,88,2012,4,11.58251424
153,150,3,6,14.76,93,2012,4,8.999285243
502,495,7,7,17.22,88,2012,4,8.9981
721,700,21,8,18.04,88,2012,4,11.0014
336,317,19,9,18.86,82,2012,4,7.0015
156,130,26,10,18.86,82,2012,4,12.998
207,183,24,11,19.68,77,2012,4,12.998
312,273,39,12,21.32,68,2012,4,12.998
272,233,39,13,22.14,64,2012,4,11.0014
270,231,39,14,23.78,56,2012,4,15.0013
300,244,56,15,24.6,49,2012,4,16.9979
435,391,44,16,23.78,49,2012,4,19.0012
731,693,38,18,20.5,63,2012,4,15.0013
460,414,46,19,19.68,67,2012,4,15.0013
306,272,34,20,20.5,63,2012,4,15.0013
280,252,28,21,20.5,63,2012,4,16.9979
181,155,26,22,20.5,63,2012,4,19.9995
96,91,5,23,19.68,67,2012,4,16.9979
37,31,6,0,20.5,59,2012,4,19.0012
11,11,0,1,21.32,55,2012,4,22.0028
9,7,2,2,18.86,67,2012,4,11.0014
7,7,0,3,19.68,67,2012,4,8.9981
10,9,1,4,20.5,63,2012,4,30.0026
49,48,1,5,20.5,59,2012,4,19.0012
124,119,5,6,19.68,55,2012,4,26.0027
398,389,9,7,18.86,59,2012,4,19.9995
388,362,26,9,18.04,51,2012,4,15.0013
141,127,14,10,18.04,47,2012,4,23.9994
172,161,11,11,18.04,44,2012,4,19.0012
232,208,24,12,18.04,41,2012,4,19.0012
214,200,14,13,18.86,41,2012,4,19.0012
218,179,39,14,19.68,33,2012,4,32.9975
285,265,20,15,19.68,33,2012,4,19.0012
377,354,23,16,18.86,33,2012,4,19.0012
605,576,29,17,18.04,35,2012,4,19.0012
609,580,29,18,17.22,35,2012,4,30.0026
414,400,14,19,15.58,43,2012,4,23.9994
293,274,19,20,13.94,46,2012,4,26.0027
198,184,14,21,13.94,46,2012,4,27.9993
105,101,4,22,13.12,45,2012,4,26.0027
74,69,5,23,12.3,49,2012,4,26.0027
44,43,1,0,10.66,48,2012,4,19.0012
16,16,0,1,10.66,48,2012,4,19.0012
9,9,0,2,9.84,52,2012,4,19.0012
2,2,0,3,9.02,55,2012,4,12.998
9,8,1,4,9.02,55,2012,4,19.9995
32,32,0,5,9.02,55,2012,4,19.0012
124,122,2,6,9.02,55,2012,4,19.9995
389,381,8,7,9.02,51,2012,4,19.9995
659,646,13,8,9.02,51,2012,4,19.9995
276,257,19,9,9.84,48,2012,4,12.998
145,122,23,10,9.84,52,2012,4,12.998
178,162,16,11,10.66,48,2012,4,11.0014
235,206,29,12,11.48,41,2012,4,6.954984671
245,212,33,13,12.3,39,2012,4,7.51077025
212,175,37,14,12.3,42,2012,4,6.0032
270,232,38,15,13.12,39,2012,4,7.790999411
331,292,39,16,13.12,42,2012,4,7.361601315
617,586,31,17,12.3,45,2012,4,7.0015
565,542,23,18,11.48,45,2012,4,11.0014
373,360,13,19,10.66,60,2012,4,12.998
227,222,5,20,9.84,60,2012,4,7.0015
191,184,7,21,9.84,60,2012,4,8.9981
133,131,2,22,9.84,65,2012,4,11.0014
93,93,0,23,9.84,65,2012,4,11.0014
48,45,3,0,9.84,70,2012,4,7.0015
28,26,2,1,9.84,70,2012,4,12.998
11,11,0,2,10.66,70,2012,4,8.9981
5,5,0,3,10.66,81,2012,4,12.998
10,10,0,4,10.66,75,2012,4,7.0015
26,25,1,5,10.66,81,2012,4,7.0015
84,84,0,6,11.48,75,2012,4,11.0014
215,212,3,7,11.48,81,2012,4,11.0014
441,430,11,8,12.3,75,2012,4,12.998
301,291,10,9,12.3,81,2012,4,8.9981
166,150,16,10,13.12,76,2012,4,11.0014
203,183,20,11,13.12,76,2012,4,12.998
240,204,36,12,13.94,71,2012,4,12.998
220,197,23,13,14.76,66,2012,4,8.9981
215,175,40,14,14.76,71,2012,4,11.0014
303,269,34,15,14.76,71,2012,4,11.0014
375,336,39,16,14.76,76,2012,4,8.9981
568,539,29,17,15.58,66,2012,4,12.73955748
498,473,25,18,15.58,71,2012,4,7.0015
352,337,15,19,15.58,76,2012,4,11.24060516
241,229,12,20,15.58,76,2012,4,7.0015
171,162,9,21,14.76,93,2012,4,7.0015
165,150,15,22,14.76,93,2012,4,6.0032
122,116,6,23,14.76,93,2012,4,6.0032
103,98,5,0,14.76,93,2012,4,6.0032
100,84,16,1,14.76,93,2012,4,8.9981
70,67,3,2,14.76,93,2012,4,8.9981
29,23,6,3,14.76,93,2012,4,7.0015
12,9,3,4,14.76,93,2012,4,8.999285243
6,4,2,5,14.76,93,2012,4,7.0015
20,19,1,6,14.76,93,2012,4,7.0015
39,36,3,7,14.76,100,2012,4,6.0032
111,106,5,8,15.58,94,2012,4,6.0032
170,153,17,9,15.58,94,2012,4,9.262565235
287,244,43,10,16.4,87,2012,4,8.9981
404,341,63,11,16.4,87,2012,4,7.0015
486,364,122,12,16.4,87,2012,4,15.0013
547,399,148,13,16.4,87,2012,4,11.0014
542,378,164,14,16.4,87,2012,4,19.0012
541,374,167,15,17.22,82,2012,4,11.0014
507,368,139,16,17.22,82,2012,4,11.0014
345,268,77,17,15.58,87,2012,4,8.9981
304,264,40,18,16.4,87,2012,4,7.0015
246,212,34,19,16.4,87,2012,4,9.509266872
182,162,20,20,14.76,100,2012,4,9.122287658
209,175,34,21,14.76,100,2012,4,9.122287658
160,137,23,22,15.58,94,2012,4,7.0015
162,144,18,23,16.4,94,2012,4,10.98684544
118,103,15,0,16.4,87,2012,4,8.9981
102,85,17,1,16.4,87,2012,4,7.0015
78,70,8,2,16.4,87,2012,4,7.0015
48,34,14,3,16.4,87,2012,4,7.0015
12,11,1,4,16.4,94,2012,4,7.0015
8,8,0,5,16.4,87,2012,4,7.0015
6,6,0,6,16.4,94,2012,4,7.0015
23,22,1,7,16.4,87,2012,4,15.0013
69,68,1,8,16.4,87,2012,4,11.0014
103,94,9,9,16.4,87,2012,4,16.9979
219,180,39,10,16.4,87,2012,4,19.0012
250,210,40,11,16.4,87,2012,4,19.9995
315,255,60,12,16.4,82,2012,4,19.9995
285,220,65,13,15.58,87,2012,4,19.0012
232,190,42,14,15.58,87,2012,4,12.998
225,200,25,15,14.76,93,2012,4,11.0014
253,220,33,16,14.76,93,2012,4,11.0014
229,209,20,17,14.76,93,2012,4,8.9981
198,181,17,18,14.76,93,2012,4,6.0032
122,110,12,19,15.58,94,2012,4,6.0032
108,102,6,20,14.76,100,2012,4,6.0032
96,86,10,21,14.76,100,2012,4,7.0015
78,75,3,22,14.76,93,2012,4,7.0015
51,48,3,23,14.76,100,2012,4,6.0032
20,20,0,0,14.76,100,2012,4,6.0032
4,4,0,1,14.76,100,2012,4,9.122287658
5,3,2,2,15.58,94,2012,4,7.0015
4,4,0,3,15.58,94,2012,4,7.0015
12,9,3,4,15.58,94,2012,4,7.0015
27,27,0,5,15.58,94,2012,4,7.0015
123,121,2,6,15.58,94,2012,4,11.0014
294,291,3,7,15.58,94,2012,4,16.9979
584,575,9,8,17.22,100,2012,4,16.9979
284,273,11,9,17.22,100,2012,4,15.0013
133,121,12,10,18.04,94,2012,4,15.0013
134,126,8,11,18.86,94,2012,4,15.0013
173,150,23,12,18.04,100,2012,4,15.0013
220,190,30,13,18.04,100,2012,4,15.0013
210,179,31,14,20.5,94,2012,4,15.0013
236,207,29,15,20.5,87,2012,4,11.0014
345,308,37,16,20.5,88,2012,4,7.0015
616,578,38,17,19.68,82,2012,4,19.0012
564,544,20,18,18.86,88,2012,4,19.0012
427,409,18,19,21.32,77,2012,4,19.0012
300,287,13,20,18.86,88,2012,4,16.9979
245,224,21,21,18.86,94,2012,4,12.998
126,115,11,22,20.5,82,2012,4,15.0013
84,76,8,23,18.86,88,2012,4,16.9979
31,29,2,0,18.86,77,2012,4,31.0009
8,7,1,1,17.22,71,2012,4,30.0026
1,1,0,2,16.4,66,2012,4,22.0028
3,3,0,3,14.76,76,2012,4,19.0012
8,8,0,4,13.94,76,2012,4,19.0012
41,40,1,5,13.94,71,2012,4,22.0028
118,118,0,6,13.94,71,2012,4,19.9995
380,372,8,7,13.94,66,2012,4,27.9993
724,708,16,8,13.94,61,2012,4,19.9995
334,322,12,9,13.94,61,2012,4,26.0027
154,142,12,10,14.76,57,2012,4,22.0028
173,145,28,11,14.76,53,2012,4,23.9994
226,213,13,12,14.76,53,2012,4,30.0026
254,226,28,13,15.58,50,2012,4,15.0013
204,185,19,14,15.58,50,2012,4,15.0013
270,250,20,15,15.58,50,2012,4,15.0013
358,334,24,16,15.58,50,2012,4,15.0013
601,580,21,17,13.12,53,2012,4,15.0013
546,523,23,18,13.12,53,2012,4,15.0013
433,412,21,19,13.12,53,2012,4,15.0013
257,248,9,20,13.12,53,2012,4,15.0013
207,193,14,21,13.12,53,2012,4,12.998
106,100,6,22,12.3,56,2012,4,15.0013
64,60,4,23,12.3,52,2012,4,15.0013
34,33,1,0,12.3,52,2012,4,11.0014
21,18,3,1,11.48,61,2012,4,15.0013
9,4,5,2,11.48,56,2012,4,11.0014
10,7,3,3,10.66,60,2012,4,8.9981
4,4,0,4,10.66,60,2012,4,9.580259223
37,37,0,5,10.66,60,2012,4,12.998
128,126,2,6,10.66,60,2012,4,16.9979
369,366,3,7,10.66,60,2012,4,12.998
688,670,18,8,10.66,65,2012,4,11.0014
285,272,13,9,11.48,61,2012,4,8.9981
136,116,20,10,12.3,56,2012,4,11.0014
172,148,24,11,13.12,49,2012,4,15.0013
232,218,14,12,13.94,42,2012,4,7.897276333
238,220,18,13,13.94,42,2012,4,7.897276333
225,191,34,14,13.94,46,2012,4,7.422645892
228,207,21,15,13.94,46,2012,4,7.0015
329,310,19,16,13.94,46,2012,4,8.9981
561,540,21,17,13.12,53,2012,4,15.0013
540,515,25,18,13.12,49,2012,4,15.0013
402,384,18,19,12.3,56,2012,4,15.0013
268,243,25,20,12.3,52,2012,4,19.0012
202,186,16,21,12.3,52,2012,4,16.9979
122,118,4,22,12.3,52,2012,4,15.0013
79,76,3,23,11.48,56,2012,4,15.0013
32,31,1,0,11.48,52,2012,4,15.0013
23,19,4,1,11.48,52,2012,4,19.0012
8,5,3,2,10.66,56,2012,4,16.9979
2,2,0,3,10.66,56,2012,4,19.0012
8,8,0,4,10.66,56,2012,4,12.998
33,31,2,5,10.66,56,2012,4,11.0014
114,112,2,6,10.66,56,2012,4,16.9979
385,380,5,7,9.84,60,2012,4,15.0013
679,655,24,8,9.84,60,2012,4,12.998
325,300,25,9,11.48,52,2012,4,16.9979
167,139,28,10,13.12,45,2012,4,19.0012
189,164,25,11,13.94,42,2012,4,16.9979
282,252,30,12,14.76,40,2012,4,16.9979
271,230,41,13,14.76,34,2012,4,12.998
242,211,31,14,14.76,34,2012,4,11.0014
280,240,40,15,14.76,34,2012,4,8.9981
406,356,50,16,13.94,39,2012,4,7.0015
550,507,43,17,13.12,42,2012,4,7.0015
466,446,20,18,13.12,42,2012,4,7.0015
348,328,20,19,12.3,45,2012,4,11.0014
241,235,6,20,12.3,45,2012,4,7.189991513
213,200,13,21,11.48,48,2012,4,6.575737183
148,141,7,22,10.66,60,2012,4,6.0032
120,115,5,23,10.66,60,2012,4,9.580259223
47,43,4,0,9.02,64,2012,4,6.0032
26,26,0,1,9.02,69,2012,4,6.0032
9,6,3,2,9.02,69,2012,4,8.715310848
12,12,0,3,8.2,69,2012,4,7.0015
10,9,1,4,8.2,75,2012,4,6.0032
34,34,0,5,8.2,69,2012,4,7.0015
113,112,1,6,6.56,80,2012,4,7.0015
308,305,3,7,8.2,72,2012,4,7.0015
636,623,13,8,8.2,69,2012,4,6.0032
343,330,13,9,9.84,75,2012,4,8.9981
190,162,28,10,10.66,81,2012,4,12.998
211,180,31,11,13.12,65,2012,4,12.998
273,244,29,12,14.76,50,2012,4,12.998
313,274,39,13,14.76,50,2012,4,15.0013
299,251,48,14,16.4,43,2012,4,12.998
309,252,57,15,16.4,47,2012,4,11.0014
417,372,45,16,15.58,54,2012,4,12.998
622,582,40,17,13.94,57,2012,4,11.0014
455,432,23,18,14.76,46,2012,4,8.9981
319,302,17,19,13.94,53,2012,4,6.0032
221,209,12,20,13.12,61,2012,4,8.9981
172,165,7,21,12.3,75,2012,4,11.0014
138,134,4,22,11.48,75,2012,4,7.0015
134,123,11,23,11.48,75,2012,4,6.0032
94,90,4,0,12.3,70,2012,4,9.487621856
95,86,9,1,10.66,81,2012,4,6.0032
69,63,6,2,10.66,81,2012,4,7.851103525
23,18,5,3,9.84,81,2012,4,8.498221699
6,5,1,4,9.84,87,2012,4,7.0015
3,3,0,5,10.66,75,2012,4,10.14251861
11,11,0,6,9.84,75,2012,4,8.569930643
48,47,1,7,9.84,75,2012,4,6.0032
119,111,8,8,10.66,75,2012,4,6.0032
220,203,17,9,10.66,75,2012,4,7.0015
273,250,23,10,13.12,61,2012,4,11.0014
393,327,66,11,13.94,61,2012,4,6.0032
453,364,89,12,15.58,50,2012,4,6.0032
456,368,88,13,15.58,54,2012,4,16.9979
426,334,92,14,16.4,50,2012,4,11.0014
447,352,95,15,17.22,47,2012,4,16.89311739
413,328,85,16,16.4,50,2012,4,8.9981
309,274,35,17,16.4,50,2012,4,15.0013
272,232,40,18,15.58,58,2012,4,11.0014
257,225,32,19,14.76,62,2012,4,8.9981
201,178,23,20,14.76,57,2012,4,12.998
184,169,15,21,14.76,62,2012,4,8.9981
156,134,22,22,14.76,62,2012,4,12.998
119,108,11,23,14.76,62,2012,4,8.9981
110,102,8,0,14.76,62,2012,4,13.39423972
96,82,14,1,13.94,76,2012,4,7.0015
87,79,8,2,13.94,87,2012,4,6.0032
38,37,1,3,13.94,87,2012,4,12.998
11,10,1,4,13.94,87,2012,4,9.010649891
9,9,0,5,13.94,87,2012,4,9.010649891
6,6,0,6,13.94,87,2012,4,9.010649891
27,22,5,7,13.94,87,2012,4,6.0032
88,76,12,8,14.76,87,2012,4,8.9981
132,113,19,9,14.76,87,2012,4,8.9981
257,215,42,10,14.76,87,2012,4,8.9981
295,248,47,11,14.76,87,2012,4,8.9981
417,350,67,12,15.58,82,2012,4,12.998
356,289,67,13,15.58,76,2012,4,12.998
310,260,50,14,15.58,76,2012,4,8.9981
338,292,46,15,15.58,82,2012,4,7.0015
400,334,66,16,15.58,82,2012,4,7.0015
243,214,29,17,15.58,82,2012,4,7.0015
107,99,8,18,15.58,82,2012,4,7.0015
109,99,10,19,14.76,93,2012,4,8.9981
122,108,14,20,15.58,82,2012,4,10.82969665
106,92,14,21,14.76,93,2012,4,8.999285243
89,83,6,22,16.4,82,2012,4,12.998
33,29,4,23,14.76,93,2012,4,8.9981
28,26,2,0,15.58,87,2012,4,9.919101878
15,14,1,1,15.58,87,2012,4,7.0015
5,4,1,2,15.58,94,2012,4,9.262565235
3,3,0,3,14.76,93,2012,4,8.999285243
5,3,2,4,14.76,100,2012,4,8.933406789
24,24,0,5,15.58,87,2012,4,9.919101878
108,107,1,6,14.76,93,2012,4,8.9981
319,314,5,7,14.76,93,2012,4,8.9981
592,582,10,8,15.58,87,2012,4,7.0015
282,271,11,9,16.4,87,2012,4,11.24701892
135,120,15,10,15.58,87,2012,4,6.0032
170,148,22,11,16.4,87,2012,4,6.0032
232,211,21,12,16.4,87,2012,4,11.24701892
210,194,16,13,16.4,87,2012,4,8.9981
181,169,12,14,16.4,87,2012,4,6.0032
211,196,15,15,17.22,88,2012,4,11.48500172
302,287,15,16,16.4,94,2012,4,16.9979
495,478,17,17,16.4,94,2012,4,16.9979
507,493,14,18,16.4,94,2012,4,6.0032
340,333,7,19,17.22,88,2012,4,8.9981
200,192,8,20,17.22,94,2012,4,16.9979
120,114,6,21,17.22,94,2012,4,8.9981
54,49,5,22,17.22,94,2012,4,8.9981
47,41,6,23,17.22,94,2012,4,15.0013
18,18,0,0,18.04,94,2012,4,8.9981
15,15,0,1,18.04,94,2012,4,8.9981
7,5,2,2,18.04,88,2012,4,15.0013
5,5,0,3,17.22,88,2012,4,12.998
8,5,3,4,17.22,82,2012,4,11.0014
36,36,0,5,15.58,87,2012,4,6.0032
118,117,1,6,14.76,93,2012,4,11.0014
355,351,4,7,14.76,93,2012,4,8.9981
662,652,10,8,15.58,94,2012,4,8.836268959
326,307,19,9,16.4,87,2012,4,6.0032
184,162,22,10,18.04,77,2012,4,6.0032
269,211,58,11,19.68,63,2012,4,15.0013
313,264,49,12,19.68,48,2012,4,16.9979
286,235,51,13,20.5,42,2012,4,19.0012
247,191,56,14,18.86,47,2012,4,30.0026
246,218,28,15,18.86,44,2012,4,32.9975
363,323,40,16,18.04,41,2012,4,31.0009
572,533,39,17,16.4,47,2012,4,30.0026
525,512,13,18,15.58,46,2012,4,22.0028
353,334,19,19,15.58,46,2012,4,26.0027
268,264,4,20,14.76,50,2012,4,16.9979
168,159,9,21,14.76,50,2012,4,15.0013
132,127,5,22,13.94,49,2012,4,11.24983532
81,80,1,23,13.94,49,2012,4,6.0032
41,35,6,0,12.3,61,2012,4,10.20220832
15,14,1,1,12.3,65,2012,4,6.0032
3,2,1,2,11.48,65,2012,4,6.0032
5,5,0,3,10.66,75,2012,4,8.9981
7,6,1,4,9.84,75,2012,4,8.9981
31,29,2,5,10.66,75,2012,4,6.0032
112,109,3,6,9.84,75,2012,4,6.0032
363,360,3,7,10.66,75,2012,4,8.9981
678,665,13,8,9.84,87,2012,4,7.0015
317,309,8,9,11.48,75,2012,4,7.0015
164,147,17,10,13.12,70,2012,4,7.0015
200,169,31,11,16.4,54,2012,4,15.0013
236,203,33,12,16.4,54,2012,4,19.0012
213,183,30,13,17.22,50,2012,4,12.998
218,185,33,14,17.22,50,2012,4,12.998
237,209,28,15,17.22,50,2012,4,19.0012
334,297,37,16,17.22,50,2012,4,23.9994
562,536,26,17,16.4,50,2012,4,26.0027
569,546,23,18,15.58,50,2012,4,23.9994
336,329,7,19,15.58,50,2012,4,26.0027
241,231,10,20,14.76,57,2012,4,15.0013
168,164,4,21,13.94,61,2012,4,15.0013
129,117,12,22,13.94,61,2012,4,6.0032
88,84,4,23,13.12,66,2012,4,8.9981